year,age,item,total,"men person","female person"
105,總計,總計,32482,27259,5223
105,總計,竊盜總計,3748,2951,797
105,總計,重大竊盜,8,6,2
105,總計,普通竊盜,3189,2434,755
105,總計,汽車竊盜,143,132,11
105,總計,機車竊盜,408,379,29
105,總計,贓物,18,15,3
105,總計,賭博,1882,1440,442
105,總計,傷害總計,1466,1249,217
105,總計,重傷害,3,3,0
105,總計,一般傷害,1463,1246,217
105,總計,詐欺背信總計,1986,1450,536
105,總計,詐欺,1900,1387,513
105,總計,背信,86,63,23
105,總計,妨害自由,862,719,143
105,總計,殺人總計,98,85,13
105,總計,故意殺人,86,79,7
105,總計,過失致死,12,6,6
105,總計,駕駛過失,1070,857,213
105,總計,妨害婚姻及家庭,88,48,40
105,總計,妨害風化,182,128,54
105,總計,妨害性自主罪總計,437,429,8
105,總計,強制性交,50,50,0
105,總計,共同強制性交,6,6,0
105,總計,對幼性交,9,9,0
105,總計,性交猥褻,372,364,8
105,總計,內亂,0,0,0
105,總計,恐嚇取財總計,79,73,6
105,總計,重大恐嚇取財,0,0,0
105,總計,一般恐嚇取財,79,73,6
105,總計,擄人勒贖,2,2,0
105,總計,侵占,361,273,88
105,總計,偽造文書印文,243,185,58
105,總計,違反毒品危害防制條例總計,11509,9897,1612
105,總計,第一級毒品,2181,1815,366
105,總計,第二級毒品,8864,7660,1204
105,總計,第三級毒品,453,412,41
105,總計,第四級毒品,4,3,1
105,總計,其他,7,7,0
105,總計,毀棄損壞,284,242,42
105,總計,妨害公務,289,263,26
105,總計,違反著作權法,147,126,21
105,總計,違反商標法,91,34,57
105,總計,妨害電腦使用,59,41,18
105,總計,強盜搶奪總計,114,107,7
105,總計,強盜,71,66,5
105,總計,搶奪,43,41,2
105,總計,竊佔,60,41,19
105,總計,偽造有價證券,26,21,5
105,總計,妨害秩序,78,68,10
105,總計,違反藥事法,15,11,4
105,總計,違反國家總動員法,0,0,0
105,總計,違反森林法,8,7,1
105,總計,公共危險,5497,5035,462
105,總計,侵害墳墓屍體,1,1,0
105,總計,重利,135,117,18
105,總計,妨害名譽,444,313,131
105,總計,違反選罷法,23,15,8
105,總計,妨害祕密,44,36,8
105,總計,遺棄,24,13,11
105,總計,違反貪污治罪條例,0,0,0
105,總計,懲治走私條例,0,0,0
105,總計,妨害兵役,0,0,0
105,總計,偽造貨幣,4,3,1
105,總計,偽造度量衡,0,0,0
105,總計,偽證,1,1,0
105,總計,誣告,49,29,20
105,總計,湮滅證據,0,0,0
105,總計,瀆職,3,2,1
105,總計,脫逃,2,2,0
105,總計,藏匿頂替,4,1,3
105,總計,違反槍砲彈藥刀械管制條例,211,201,10
105,總計,違反就業服務法,0,0,0
105,總計,其他,838,728,110
105,00-05歲嫌犯數,總計,0,0,0
105,00-05歲嫌犯數,竊盜總計,0,0,0
105,00-05歲嫌犯數,重大竊盜,0,0,0
105,00-05歲嫌犯數,普通竊盜,0,0,0
105,00-05歲嫌犯數,汽車竊盜,0,0,0
105,00-05歲嫌犯數,機車竊盜,0,0,0
105,00-05歲嫌犯數,贓物,0,0,0
105,00-05歲嫌犯數,賭博,0,0,0
105,00-05歲嫌犯數,傷害總計,0,0,0
105,00-05歲嫌犯數,重傷害,0,0,0
105,00-05歲嫌犯數,一般傷害,0,0,0
105,00-05歲嫌犯數,詐欺背信總計,0,0,0
105,00-05歲嫌犯數,詐欺,0,0,0
105,00-05歲嫌犯數,背信,0,0,0
105,00-05歲嫌犯數,妨害自由,0,0,0
105,00-05歲嫌犯數,殺人總計,0,0,0
105,00-05歲嫌犯數,故意殺人,0,0,0
105,00-05歲嫌犯數,過失致死,0,0,0
105,00-05歲嫌犯數,駕駛過失,0,0,0
105,00-05歲嫌犯數,妨害婚姻及家庭,0,0,0
105,00-05歲嫌犯數,妨害風化,0,0,0
105,00-05歲嫌犯數,妨害性自主罪總計,0,0,0
105,00-05歲嫌犯數,強制性交,0,0,0
105,00-05歲嫌犯數,共同強制性交,0,0,0
105,00-05歲嫌犯數,對幼性交,0,0,0
105,00-05歲嫌犯數,性交猥褻,0,0,0
105,00-05歲嫌犯數,內亂,0,0,0
105,00-05歲嫌犯數,恐嚇取財總計,0,0,0
105,00-05歲嫌犯數,重大恐嚇取財,0,0,0
105,00-05歲嫌犯數,一般恐嚇取財,0,0,0
105,00-05歲嫌犯數,擄人勒贖,0,0,0
105,00-05歲嫌犯數,侵占,0,0,0
105,00-05歲嫌犯數,偽造文書印文,0,0,0
105,00-05歲嫌犯數,違反毒品危害防制條例總計,0,0,0
105,00-05歲嫌犯數,第一級毒品,0,0,0
105,00-05歲嫌犯數,第二級毒品,0,0,0
105,00-05歲嫌犯數,第三級毒品,0,0,0
105,00-05歲嫌犯數,第四級毒品,0,0,0
105,00-05歲嫌犯數,其他,0,0,0
105,00-05歲嫌犯數,毀棄損壞,0,0,0
105,00-05歲嫌犯數,妨害公務,0,0,0
105,00-05歲嫌犯數,違反著作權法,0,0,0
105,00-05歲嫌犯數,違反商標法,0,0,0
105,00-05歲嫌犯數,妨害電腦使用,0,0,0
105,00-05歲嫌犯數,強盜搶奪總計,0,0,0
105,00-05歲嫌犯數,強盜,0,0,0
105,00-05歲嫌犯數,搶奪,0,0,0
105,00-05歲嫌犯數,竊佔,0,0,0
105,00-05歲嫌犯數,偽造有價證券,0,0,0
105,00-05歲嫌犯數,妨害秩序,0,0,0
105,00-05歲嫌犯數,違反藥事法,0,0,0
105,00-05歲嫌犯數,違反國家總動員法,0,0,0
105,00-05歲嫌犯數,違反森林法,0,0,0
105,00-05歲嫌犯數,公共危險,0,0,0
105,00-05歲嫌犯數,侵害墳墓屍體,0,0,0
105,00-05歲嫌犯數,重利,0,0,0
105,00-05歲嫌犯數,妨害名譽,0,0,0
105,00-05歲嫌犯數,違反選罷法,0,0,0
105,00-05歲嫌犯數,妨害祕密,0,0,0
105,00-05歲嫌犯數,遺棄,0,0,0
105,00-05歲嫌犯數,違反貪污治罪條例,0,0,0
105,00-05歲嫌犯數,懲治走私條例,0,0,0
105,00-05歲嫌犯數,妨害兵役,0,0,0
105,00-05歲嫌犯數,偽造貨幣,0,0,0
105,00-05歲嫌犯數,偽造度量衡,0,0,0
105,00-05歲嫌犯數,偽證,0,0,0
105,00-05歲嫌犯數,誣告,0,0,0
105,00-05歲嫌犯數,湮滅證據,0,0,0
105,00-05歲嫌犯數,瀆職,0,0,0
105,00-05歲嫌犯數,脫逃,0,0,0
105,00-05歲嫌犯數,藏匿頂替,0,0,0
105,00-05歲嫌犯數,違反槍砲彈藥刀械管制條例,0,0,0
105,00-05歲嫌犯數,違反就業服務法,0,0,0
105,00-05歲嫌犯數,其他,0,0,0
105,6-11歲嫌犯數,總計,81,65,16
105,6-11歲嫌犯數,竊盜總計,54,39,15
105,6-11歲嫌犯數,重大竊盜,0,0,0
105,6-11歲嫌犯數,普通竊盜,51,36,15
105,6-11歲嫌犯數,汽車竊盜,0,0,0
105,6-11歲嫌犯數,機車竊盜,3,3,0
105,6-11歲嫌犯數,贓物,0,0,0
105,6-11歲嫌犯數,賭博,0,0,0
105,6-11歲嫌犯數,傷害總計,4,4,0
105,6-11歲嫌犯數,重傷害,0,0,0
105,6-11歲嫌犯數,一般傷害,4,4,0
105,6-11歲嫌犯數,詐欺背信總計,1,1,0
105,6-11歲嫌犯數,詐欺,1,1,0
105,6-11歲嫌犯數,背信,0,0,0
105,6-11歲嫌犯數,妨害自由,0,0,0
105,6-11歲嫌犯數,殺人總計,0,0,0
105,6-11歲嫌犯數,故意殺人,0,0,0
105,6-11歲嫌犯數,過失致死,0,0,0
105,6-11歲嫌犯數,駕駛過失,2,2,0
105,6-11歲嫌犯數,妨害婚姻及家庭,0,0,0
105,6-11歲嫌犯數,妨害風化,0,0,0
105,6-11歲嫌犯數,妨害性自主罪總計,15,15,0
105,6-11歲嫌犯數,強制性交,1,1,0
105,6-11歲嫌犯數,共同強制性交,1,1,0
105,6-11歲嫌犯數,對幼性交,1,1,0
105,6-11歲嫌犯數,性交猥褻,12,12,0
105,6-11歲嫌犯數,內亂,0,0,0
105,6-11歲嫌犯數,恐嚇取財總計,0,0,0
105,6-11歲嫌犯數,重大恐嚇取財,0,0,0
105,6-11歲嫌犯數,一般恐嚇取財,0,0,0
105,6-11歲嫌犯數,擄人勒贖,0,0,0
105,6-11歲嫌犯數,侵占,2,1,1
105,6-11歲嫌犯數,偽造文書印文,0,0,0
105,6-11歲嫌犯數,違反毒品危害防制條例總計,0,0,0
105,6-11歲嫌犯數,第一級毒品,0,0,0
105,6-11歲嫌犯數,第二級毒品,0,0,0
105,6-11歲嫌犯數,第三級毒品,0,0,0
105,6-11歲嫌犯數,第四級毒品,0,0,0
105,6-11歲嫌犯數,其他,0,0,0
105,6-11歲嫌犯數,毀棄損壞,1,1,0
105,6-11歲嫌犯數,妨害公務,0,0,0
105,6-11歲嫌犯數,違反著作權法,0,0,0
105,6-11歲嫌犯數,違反商標法,0,0,0
105,6-11歲嫌犯數,妨害電腦使用,0,0,0
105,6-11歲嫌犯數,強盜搶奪總計,0,0,0
105,6-11歲嫌犯數,強盜,0,0,0
105,6-11歲嫌犯數,搶奪,0,0,0
105,6-11歲嫌犯數,竊佔,0,0,0
105,6-11歲嫌犯數,偽造有價證券,0,0,0
105,6-11歲嫌犯數,妨害秩序,0,0,0
105,6-11歲嫌犯數,違反藥事法,0,0,0
105,6-11歲嫌犯數,違反國家總動員法,0,0,0
105,6-11歲嫌犯數,違反森林法,0,0,0
105,6-11歲嫌犯數,公共危險,1,1,0
105,6-11歲嫌犯數,侵害墳墓屍體,0,0,0
105,6-11歲嫌犯數,重利,0,0,0
105,6-11歲嫌犯數,妨害名譽,1,1,0
105,6-11歲嫌犯數,違反選罷法,0,0,0
105,6-11歲嫌犯數,妨害祕密,0,0,0
105,6-11歲嫌犯數,遺棄,0,0,0
105,6-11歲嫌犯數,違反貪污治罪條例,0,0,0
105,6-11歲嫌犯數,懲治走私條例,0,0,0
105,6-11歲嫌犯數,妨害兵役,0,0,0
105,6-11歲嫌犯數,偽造貨幣,0,0,0
105,6-11歲嫌犯數,偽造度量衡,0,0,0
105,6-11歲嫌犯數,偽證,0,0,0
105,6-11歲嫌犯數,誣告,0,0,0
105,6-11歲嫌犯數,湮滅證據,0,0,0
105,6-11歲嫌犯數,瀆職,0,0,0
105,6-11歲嫌犯數,脫逃,0,0,0
105,6-11歲嫌犯數,藏匿頂替,0,0,0
105,6-11歲嫌犯數,違反槍砲彈藥刀械管制條例,0,0,0
105,6-11歲嫌犯數,違反就業服務法,0,0,0
105,6-11歲嫌犯數,其他,0,0,0
105,12-17歲嫌犯數,總計,1399,1205,194
105,12-17歲嫌犯數,竊盜總計,300,262,38
105,12-17歲嫌犯數,重大竊盜,0,0,0
105,12-17歲嫌犯數,普通竊盜,209,176,33
105,12-17歲嫌犯數,汽車竊盜,3,3,0
105,12-17歲嫌犯數,機車竊盜,88,83,5
105,12-17歲嫌犯數,贓物,0,0,0
105,12-17歲嫌犯數,賭博,23,22,1
105,12-17歲嫌犯數,傷害總計,106,94,12
105,12-17歲嫌犯數,重傷害,0,0,0
105,12-17歲嫌犯數,一般傷害,106,94,12
105,12-17歲嫌犯數,詐欺背信總計,106,91,15
105,12-17歲嫌犯數,詐欺,106,91,15
105,12-17歲嫌犯數,背信,0,0,0
105,12-17歲嫌犯數,妨害自由,35,30,5
105,12-17歲嫌犯數,殺人總計,20,20,0
105,12-17歲嫌犯數,故意殺人,20,20,0
105,12-17歲嫌犯數,過失致死,0,0,0
105,12-17歲嫌犯數,駕駛過失,26,23,3
105,12-17歲嫌犯數,妨害婚姻及家庭,3,3,0
105,12-17歲嫌犯數,妨害風化,2,2,0
105,12-17歲嫌犯數,妨害性自主罪總計,80,74,6
105,12-17歲嫌犯數,強制性交,9,9,0
105,12-17歲嫌犯數,共同強制性交,1,1,0
105,12-17歲嫌犯數,對幼性交,2,2,0
105,12-17歲嫌犯數,性交猥褻,68,62,6
105,12-17歲嫌犯數,內亂,0,0,0
105,12-17歲嫌犯數,恐嚇取財總計,4,4,0
105,12-17歲嫌犯數,重大恐嚇取財,0,0,0
105,12-17歲嫌犯數,一般恐嚇取財,4,4,0
105,12-17歲嫌犯數,擄人勒贖,0,0,0
105,12-17歲嫌犯數,侵占,6,4,2
105,12-17歲嫌犯數,偽造文書印文,2,1,1
105,12-17歲嫌犯數,違反毒品危害防制條例總計,516,427,89
105,12-17歲嫌犯數,第一級毒品,12,8,4
105,12-17歲嫌犯數,第二級毒品,398,324,74
105,12-17歲嫌犯數,第三級毒品,104,93,11
105,12-17歲嫌犯數,第四級毒品,0,0,0
105,12-17歲嫌犯數,其他,2,2,0
105,12-17歲嫌犯數,毀棄損壞,6,5,1
105,12-17歲嫌犯數,妨害公務,5,5,0
105,12-17歲嫌犯數,違反著作權法,0,0,0
105,12-17歲嫌犯數,違反商標法,1,0,1
105,12-17歲嫌犯數,妨害電腦使用,4,4,0
105,12-17歲嫌犯數,強盜搶奪總計,7,7,0
105,12-17歲嫌犯數,強盜,6,6,0
105,12-17歲嫌犯數,搶奪,1,1,0
105,12-17歲嫌犯數,竊佔,0,0,0
105,12-17歲嫌犯數,偽造有價證券,3,3,0
105,12-17歲嫌犯數,妨害秩序,11,11,0
105,12-17歲嫌犯數,違反藥事法,0,0,0
105,12-17歲嫌犯數,違反國家總動員法,0,0,0
105,12-17歲嫌犯數,違反森林法,0,0,0
105,12-17歲嫌犯數,公共危險,51,46,5
105,12-17歲嫌犯數,侵害墳墓屍體,0,0,0
105,12-17歲嫌犯數,重利,1,1,0
105,12-17歲嫌犯數,妨害名譽,31,24,7
105,12-17歲嫌犯數,違反選罷法,0,0,0
105,12-17歲嫌犯數,妨害祕密,5,3,2
105,12-17歲嫌犯數,遺棄,0,0,0
105,12-17歲嫌犯數,違反貪污治罪條例,0,0,0
105,12-17歲嫌犯數,懲治走私條例,0,0,0
105,12-17歲嫌犯數,妨害兵役,0,0,0
105,12-17歲嫌犯數,偽造貨幣,0,0,0
105,12-17歲嫌犯數,偽造度量衡,0,0,0
105,12-17歲嫌犯數,偽證,0,0,0
105,12-17歲嫌犯數,誣告,0,0,0
105,12-17歲嫌犯數,湮滅證據,0,0,0
105,12-17歲嫌犯數,瀆職,0,0,0
105,12-17歲嫌犯數,脫逃,0,0,0
105,12-17歲嫌犯數,藏匿頂替,0,0,0
105,12-17歲嫌犯數,違反槍砲彈藥刀械管制條例,4,4,0
105,12-17歲嫌犯數,違反就業服務法,0,0,0
105,12-17歲嫌犯數,其他,41,35,6
105,18-23歲嫌犯數,總計,4340,3690,650
105,18-23歲嫌犯數,竊盜總計,299,262,37
105,18-23歲嫌犯數,重大竊盜,2,2,0
105,18-23歲嫌犯數,普通竊盜,220,187,33
105,18-23歲嫌犯數,汽車竊盜,12,9,3
105,18-23歲嫌犯數,機車竊盜,65,64,1
105,18-23歲嫌犯數,贓物,1,1,0
105,18-23歲嫌犯數,賭博,106,90,16
105,18-23歲嫌犯數,傷害總計,205,192,13
105,18-23歲嫌犯數,重傷害,0,0,0
105,18-23歲嫌犯數,一般傷害,205,192,13
105,18-23歲嫌犯數,詐欺背信總計,548,421,127
105,18-23歲嫌犯數,詐欺,543,416,127
105,18-23歲嫌犯數,背信,5,5,0
105,18-23歲嫌犯數,妨害自由,102,95,7
105,18-23歲嫌犯數,殺人總計,32,29,3
105,18-23歲嫌犯數,故意殺人,29,28,1
105,18-23歲嫌犯數,過失致死,3,1,2
105,18-23歲嫌犯數,駕駛過失,173,142,31
105,18-23歲嫌犯數,妨害婚姻及家庭,10,7,3
105,18-23歲嫌犯數,妨害風化,14,10,4
105,18-23歲嫌犯數,妨害性自主罪總計,101,101,0
105,18-23歲嫌犯數,強制性交,12,12,0
105,18-23歲嫌犯數,共同強制性交,1,1,0
105,18-23歲嫌犯數,對幼性交,3,3,0
105,18-23歲嫌犯數,性交猥褻,85,85,0
105,18-23歲嫌犯數,內亂,0,0,0
105,18-23歲嫌犯數,恐嚇取財總計,26,24,2
105,18-23歲嫌犯數,重大恐嚇取財,0,0,0
105,18-23歲嫌犯數,一般恐嚇取財,26,24,2
105,18-23歲嫌犯數,擄人勒贖,1,1,0
105,18-23歲嫌犯數,侵占,42,36,6
105,18-23歲嫌犯數,偽造文書印文,53,45,8
105,18-23歲嫌犯數,違反毒品危害防制條例總計,1889,1595,294
105,18-23歲嫌犯數,第一級毒品,54,36,18
105,18-23歲嫌犯數,第二級毒品,1635,1373,262
105,18-23歲嫌犯數,第三級毒品,193,180,13
105,18-23歲嫌犯數,第四級毒品,2,1,1
105,18-23歲嫌犯數,其他,5,5,0
105,18-23歲嫌犯數,毀棄損壞,28,26,2
105,18-23歲嫌犯數,妨害公務,51,46,5
105,18-23歲嫌犯數,違反著作權法,8,8,0
105,18-23歲嫌犯數,違反商標法,20,2,18
105,18-23歲嫌犯數,妨害電腦使用,8,5,3
105,18-23歲嫌犯數,強盜搶奪總計,18,16,2
105,18-23歲嫌犯數,強盜,15,14,1
105,18-23歲嫌犯數,搶奪,3,2,1
105,18-23歲嫌犯數,竊佔,1,1,0
105,18-23歲嫌犯數,偽造有價證券,14,11,3
105,18-23歲嫌犯數,妨害秩序,44,41,3
105,18-23歲嫌犯數,違反藥事法,2,1,1
105,18-23歲嫌犯數,違反國家總動員法,0,0,0
105,18-23歲嫌犯數,違反森林法,0,0,0
105,18-23歲嫌犯數,公共危險,296,262,34
105,18-23歲嫌犯數,侵害墳墓屍體,0,0,0
105,18-23歲嫌犯數,重利,14,13,1
105,18-23歲嫌犯數,妨害名譽,61,49,12
105,18-23歲嫌犯數,違反選罷法,0,0,0
105,18-23歲嫌犯數,妨害祕密,5,4,1
105,18-23歲嫌犯數,遺棄,2,0,2
105,18-23歲嫌犯數,違反貪污治罪條例,0,0,0
105,18-23歲嫌犯數,懲治走私條例,0,0,0
105,18-23歲嫌犯數,妨害兵役,0,0,0
105,18-23歲嫌犯數,偽造貨幣,1,1,0
105,18-23歲嫌犯數,偽造度量衡,0,0,0
105,18-23歲嫌犯數,偽證,1,1,0
105,18-23歲嫌犯數,誣告,5,4,1
105,18-23歲嫌犯數,湮滅證據,0,0,0
105,18-23歲嫌犯數,瀆職,0,0,0
105,18-23歲嫌犯數,脫逃,0,0,0
105,18-23歲嫌犯數,藏匿頂替,2,0,2
105,18-23歲嫌犯數,違反槍砲彈藥刀械管制條例,50,48,2
105,18-23歲嫌犯數,違反就業服務法,0,0,0
105,18-23歲嫌犯數,其他,107,100,7
105,24-29歲嫌犯數,總計,4243,3501,742
105,24-29歲嫌犯數,竊盜總計,356,284,72
105,24-29歲嫌犯數,重大竊盜,1,1,0
105,24-29歲嫌犯數,普通竊盜,310,246,64
105,24-29歲嫌犯數,汽車竊盜,17,13,4
105,24-29歲嫌犯數,機車竊盜,28,24,4
105,24-29歲嫌犯數,贓物,2,2,0
105,24-29歲嫌犯數,賭博,173,153,20
105,24-29歲嫌犯數,傷害總計,141,129,12
105,24-29歲嫌犯數,重傷害,1,1,0
105,24-29歲嫌犯數,一般傷害,140,128,12
105,24-29歲嫌犯數,詐欺背信總計,379,277,102
105,24-29歲嫌犯數,詐欺,371,273,98
105,24-29歲嫌犯數,背信,8,4,4
105,24-29歲嫌犯數,妨害自由,94,79,15
105,24-29歲嫌犯數,殺人總計,14,11,3
105,24-29歲嫌犯數,故意殺人,13,10,3
105,24-29歲嫌犯數,過失致死,1,1,0
105,24-29歲嫌犯數,駕駛過失,142,114,28
105,24-29歲嫌犯數,妨害婚姻及家庭,12,2,10
105,24-29歲嫌犯數,妨害風化,22,19,3
105,24-29歲嫌犯數,妨害性自主罪總計,51,51,0
105,24-29歲嫌犯數,強制性交,3,3,0
105,24-29歲嫌犯數,共同強制性交,0,0,0
105,24-29歲嫌犯數,對幼性交,1,1,0
105,24-29歲嫌犯數,性交猥褻,47,47,0
105,24-29歲嫌犯數,內亂,0,0,0
105,24-29歲嫌犯數,恐嚇取財總計,15,14,1
105,24-29歲嫌犯數,重大恐嚇取財,0,0,0
105,24-29歲嫌犯數,一般恐嚇取財,15,14,1
105,24-29歲嫌犯數,擄人勒贖,0,0,0
105,24-29歲嫌犯數,侵占,47,34,13
105,24-29歲嫌犯數,偽造文書印文,33,27,6
105,24-29歲嫌犯數,違反毒品危害防制條例總計,1896,1548,348
105,24-29歲嫌犯數,第一級毒品,132,85,47
105,24-29歲嫌犯數,第二級毒品,1682,1392,290
105,24-29歲嫌犯數,第三級毒品,82,71,11
105,24-29歲嫌犯數,第四級毒品,0,0,0
105,24-29歲嫌犯數,其他,0,0,0
105,24-29歲嫌犯數,毀棄損壞,31,27,4
105,24-29歲嫌犯數,妨害公務,37,37,0
105,24-29歲嫌犯數,違反著作權法,20,20,0
105,24-29歲嫌犯數,違反商標法,20,7,13
105,24-29歲嫌犯數,妨害電腦使用,14,12,2
105,24-29歲嫌犯數,強盜搶奪總計,13,13,0
105,24-29歲嫌犯數,強盜,12,12,0
105,24-29歲嫌犯數,搶奪,1,1,0
105,24-29歲嫌犯數,竊佔,2,2,0
105,24-29歲嫌犯數,偽造有價證券,4,4,0
105,24-29歲嫌犯數,妨害秩序,10,5,5
105,24-29歲嫌犯數,違反藥事法,4,3,1
105,24-29歲嫌犯數,違反國家總動員法,0,0,0
105,24-29歲嫌犯數,違反森林法,1,1,0
105,24-29歲嫌犯數,公共危險,427,388,39
105,24-29歲嫌犯數,侵害墳墓屍體,0,0,0
105,24-29歲嫌犯數,重利,31,28,3
105,24-29歲嫌犯數,妨害名譽,55,42,13
105,24-29歲嫌犯數,違反選罷法,1,0,1
105,24-29歲嫌犯數,妨害祕密,11,9,2
105,24-29歲嫌犯數,遺棄,1,1,0
105,24-29歲嫌犯數,違反貪污治罪條例,0,0,0
105,24-29歲嫌犯數,懲治走私條例,0,0,0
105,24-29歲嫌犯數,妨害兵役,0,0,0
105,24-29歲嫌犯數,偽造貨幣,0,0,0
105,24-29歲嫌犯數,偽造度量衡,0,0,0
105,24-29歲嫌犯數,偽證,0,0,0
105,24-29歲嫌犯數,誣告,5,3,2
105,24-29歲嫌犯數,湮滅證據,0,0,0
105,24-29歲嫌犯數,瀆職,2,2,0
105,24-29歲嫌犯數,脫逃,0,0,0
105,24-29歲嫌犯數,藏匿頂替,1,1,0
105,24-29歲嫌犯數,違反槍砲彈藥刀械管制條例,42,38,4
105,24-29歲嫌犯數,違反就業服務法,0,0,0
105,24-29歲嫌犯數,其他,134,114,20
105,30-39歲嫌犯數,總計,9147,7670,1477
105,30-39歲嫌犯數,竊盜總計,1021,846,175
105,30-39歲嫌犯數,重大竊盜,1,1,0
105,30-39歲嫌犯數,普通竊盜,867,706,161
105,30-39歲嫌犯數,汽車竊盜,55,53,2
105,30-39歲嫌犯數,機車竊盜,98,86,12
105,30-39歲嫌犯數,贓物,8,7,1
105,30-39歲嫌犯數,賭博,309,240,69
105,30-39歲嫌犯數,傷害總計,391,317,74
105,30-39歲嫌犯數,重傷害,2,2,0
105,30-39歲嫌犯數,一般傷害,389,315,74
105,30-39歲嫌犯數,詐欺背信總計,452,307,145
105,30-39歲嫌犯數,詐欺,433,294,139
105,30-39歲嫌犯數,背信,19,13,6
105,30-39歲嫌犯數,妨害自由,194,168,26
105,30-39歲嫌犯數,殺人總計,11,10,1
105,30-39歲嫌犯數,故意殺人,9,8,1
105,30-39歲嫌犯數,過失致死,2,2,0
105,30-39歲嫌犯數,駕駛過失,218,174,44
105,30-39歲嫌犯數,妨害婚姻及家庭,29,14,15
105,30-39歲嫌犯數,妨害風化,68,42,26
105,30-39歲嫌犯數,妨害性自主罪總計,82,82,0
105,30-39歲嫌犯數,強制性交,15,15,0
105,30-39歲嫌犯數,共同強制性交,3,3,0
105,30-39歲嫌犯數,對幼性交,2,2,0
105,30-39歲嫌犯數,性交猥褻,62,62,0
105,30-39歲嫌犯數,內亂,0,0,0
105,30-39歲嫌犯數,恐嚇取財總計,16,16,0
105,30-39歲嫌犯數,重大恐嚇取財,0,0,0
105,30-39歲嫌犯數,一般恐嚇取財,16,16,0
105,30-39歲嫌犯數,擄人勒贖,1,1,0
105,30-39歲嫌犯數,侵占,112,88,24
105,30-39歲嫌犯數,偽造文書印文,56,42,14
105,30-39歲嫌犯數,違反毒品危害防制條例總計,4075,3488,587
105,30-39歲嫌犯數,第一級毒品,941,743,198
105,30-39歲嫌犯數,第二級毒品,3074,2690,384
105,30-39歲嫌犯數,第三級毒品,58,53,5
105,30-39歲嫌犯數,第四級毒品,2,2,0
105,30-39歲嫌犯數,其他,0,0,0
105,30-39歲嫌犯數,毀棄損壞,79,66,13
105,30-39歲嫌犯數,妨害公務,74,63,11
105,30-39歲嫌犯數,違反著作權法,59,50,9
105,30-39歲嫌犯數,違反商標法,36,17,19
105,30-39歲嫌犯數,妨害電腦使用,17,11,6
105,30-39歲嫌犯數,強盜搶奪總計,37,34,3
105,30-39歲嫌犯數,強盜,17,15,2
105,30-39歲嫌犯數,搶奪,20,19,1
105,30-39歲嫌犯數,竊佔,13,11,2
105,30-39歲嫌犯數,偽造有價證券,0,0,0
105,30-39歲嫌犯數,妨害秩序,6,5,1
105,30-39歲嫌犯數,違反藥事法,3,3,0
105,30-39歲嫌犯數,違反國家總動員法,0,0,0
105,30-39歲嫌犯數,違反森林法,5,4,1
105,30-39歲嫌犯數,公共危險,1294,1169,125
105,30-39歲嫌犯數,侵害墳墓屍體,0,0,0
105,30-39歲嫌犯數,重利,47,39,8
105,30-39歲嫌犯數,妨害名譽,94,63,31
105,30-39歲嫌犯數,違反選罷法,4,3,1
105,30-39歲嫌犯數,妨害祕密,10,9,1
105,30-39歲嫌犯數,遺棄,10,4,6
105,30-39歲嫌犯數,違反貪污治罪條例,0,0,0
105,30-39歲嫌犯數,懲治走私條例,0,0,0
105,30-39歲嫌犯數,妨害兵役,0,0,0
105,30-39歲嫌犯數,偽造貨幣,2,2,0
105,30-39歲嫌犯數,偽造度量衡,0,0,0
105,30-39歲嫌犯數,偽證,0,0,0
105,30-39歲嫌犯數,誣告,10,5,5
105,30-39歲嫌犯數,湮滅證據,0,0,0
105,30-39歲嫌犯數,瀆職,0,0,0
105,30-39歲嫌犯數,脫逃,0,0,0
105,30-39歲嫌犯數,藏匿頂替,0,0,0
105,30-39歲嫌犯數,違反槍砲彈藥刀械管制條例,64,61,3
105,30-39歲嫌犯數,違反就業服務法,0,0,0
105,30-39歲嫌犯數,其他,240,209,31
105,40-49歲嫌犯數,總計,6786,5863,923
105,40-49歲嫌犯數,竊盜總計,809,651,158
105,40-49歲嫌犯數,重大竊盜,2,2,0
105,40-49歲嫌犯數,普通竊盜,689,537,152
105,40-49歲嫌犯數,汽車竊盜,39,38,1
105,40-49歲嫌犯數,機車竊盜,79,74,5
105,40-49歲嫌犯數,贓物,3,2,1
105,40-49歲嫌犯數,賭博,280,217,63
105,40-49歲嫌犯數,傷害總計,274,232,42
105,40-49歲嫌犯數,重傷害,0,0,0
105,40-49歲嫌犯數,一般傷害,274,232,42
105,40-49歲嫌犯數,詐欺背信總計,250,182,68
105,40-49歲嫌犯數,詐欺,229,165,64
105,40-49歲嫌犯數,背信,21,17,4
105,40-49歲嫌犯數,妨害自由,220,179,41
105,40-49歲嫌犯數,殺人總計,10,7,3
105,40-49歲嫌犯數,故意殺人,7,6,1
105,40-49歲嫌犯數,過失致死,3,1,2
105,40-49歲嫌犯數,駕駛過失,182,139,43
105,40-49歲嫌犯數,妨害婚姻及家庭,22,14,8
105,40-49歲嫌犯數,妨害風化,42,32,10
105,40-49歲嫌犯數,妨害性自主罪總計,49,49,0
105,40-49歲嫌犯數,強制性交,5,5,0
105,40-49歲嫌犯數,共同強制性交,0,0,0
105,40-49歲嫌犯數,對幼性交,0,0,0
105,40-49歲嫌犯數,性交猥褻,44,44,0
105,40-49歲嫌犯數,內亂,0,0,0
105,40-49歲嫌犯數,恐嚇取財總計,8,7,1
105,40-49歲嫌犯數,重大恐嚇取財,0,0,0
105,40-49歲嫌犯數,一般恐嚇取財,8,7,1
105,40-49歲嫌犯數,擄人勒贖,0,0,0
105,40-49歲嫌犯數,侵占,70,47,23
105,40-49歲嫌犯數,偽造文書印文,48,39,9
105,40-49歲嫌犯數,違反毒品危害防制條例總計,2351,2109,242
105,40-49歲嫌犯數,第一級毒品,726,645,81
105,40-49歲嫌犯數,第二級毒品,1611,1451,160
105,40-49歲嫌犯數,第三級毒品,14,13,1
105,40-49歲嫌犯數,第四級毒品,0,0,0
105,40-49歲嫌犯數,其他,0,0,0
105,40-49歲嫌犯數,毀棄損壞,55,46,9
105,40-49歲嫌犯數,妨害公務,72,69,3
105,40-49歲嫌犯數,違反著作權法,35,29,6
105,40-49歲嫌犯數,違反商標法,8,5,3
105,40-49歲嫌犯數,妨害電腦使用,6,3,3
105,40-49歲嫌犯數,強盜搶奪總計,28,27,1
105,40-49歲嫌犯數,強盜,15,14,1
105,40-49歲嫌犯數,搶奪,13,13,0
105,40-49歲嫌犯數,竊佔,10,8,2
105,40-49歲嫌犯數,偽造有價證券,1,1,0
105,40-49歲嫌犯數,妨害秩序,4,4,0
105,40-49歲嫌犯數,違反藥事法,3,2,1
105,40-49歲嫌犯數,違反國家總動員法,0,0,0
105,40-49歲嫌犯數,違反森林法,1,1,0
105,40-49歲嫌犯數,公共危險,1605,1482,123
105,40-49歲嫌犯數,侵害墳墓屍體,0,0,0
105,40-49歲嫌犯數,重利,33,32,1
105,40-49歲嫌犯數,妨害名譽,85,58,27
105,40-49歲嫌犯數,違反選罷法,5,3,2
105,40-49歲嫌犯數,妨害祕密,6,5,1
105,40-49歲嫌犯數,遺棄,4,3,1
105,40-49歲嫌犯數,違反貪污治罪條例,0,0,0
105,40-49歲嫌犯數,懲治走私條例,0,0,0
105,40-49歲嫌犯數,妨害兵役,0,0,0
105,40-49歲嫌犯數,偽造貨幣,0,0,0
105,40-49歲嫌犯數,偽造度量衡,0,0,0
105,40-49歲嫌犯數,偽證,0,0,0
105,40-49歲嫌犯數,誣告,12,6,6
105,40-49歲嫌犯數,湮滅證據,0,0,0
105,40-49歲嫌犯數,瀆職,1,0,1
105,40-49歲嫌犯數,脫逃,1,1,0
105,40-49歲嫌犯數,藏匿頂替,0,0,0
105,40-49歲嫌犯數,違反槍砲彈藥刀械管制條例,40,39,1
105,40-49歲嫌犯數,違反就業服務法,0,0,0
105,40-49歲嫌犯數,其他,153,133,20
105,50-59歲嫌犯數,總計,4222,3496,726
105,50-59歲嫌犯數,竊盜總計,530,378,152
105,50-59歲嫌犯數,重大竊盜,1,0,1
105,50-59歲嫌犯數,普通竊盜,479,330,149
105,50-59歲嫌犯數,汽車竊盜,16,15,1
105,50-59歲嫌犯數,機車竊盜,34,33,1
105,50-59歲嫌犯數,贓物,2,1,1
105,50-59歲嫌犯數,賭博,471,347,124
105,50-59歲嫌犯數,傷害總計,211,171,40
105,50-59歲嫌犯數,重傷害,0,0,0
105,50-59歲嫌犯數,一般傷害,211,171,40
105,50-59歲嫌犯數,詐欺背信總計,178,115,63
105,50-59歲嫌犯數,詐欺,158,102,56
105,50-59歲嫌犯數,背信,20,13,7
105,50-59歲嫌犯數,妨害自由,130,100,30
105,50-59歲嫌犯數,殺人總計,5,4,1
105,50-59歲嫌犯數,故意殺人,3,3,0
105,50-59歲嫌犯數,過失致死,2,1,1
105,50-59歲嫌犯數,駕駛過失,196,151,45
105,50-59歲嫌犯數,妨害婚姻及家庭,10,6,4
105,50-59歲嫌犯數,妨害風化,25,18,7
105,50-59歲嫌犯數,妨害性自主罪總計,36,35,1
105,50-59歲嫌犯數,強制性交,5,5,0
105,50-59歲嫌犯數,共同強制性交,0,0,0
105,50-59歲嫌犯數,對幼性交,0,0,0
105,50-59歲嫌犯數,性交猥褻,31,30,1
105,50-59歲嫌犯數,內亂,0,0,0
105,50-59歲嫌犯數,恐嚇取財總計,9,7,2
105,50-59歲嫌犯數,重大恐嚇取財,0,0,0
105,50-59歲嫌犯數,一般恐嚇取財,9,7,2
105,50-59歲嫌犯數,擄人勒贖,0,0,0
105,50-59歲嫌犯數,侵占,50,36,14
105,50-59歲嫌犯數,偽造文書印文,35,20,15
105,50-59歲嫌犯數,違反毒品危害防制條例總計,654,610,44
105,50-59歲嫌犯數,第一級毒品,260,244,16
105,50-59歲嫌犯數,第二級毒品,393,365,28
105,50-59歲嫌犯數,第三級毒品,1,1,0
105,50-59歲嫌犯數,第四級毒品,0,0,0
105,50-59歲嫌犯數,其他,0,0,0
105,50-59歲嫌犯數,毀棄損壞,51,46,5
105,50-59歲嫌犯數,妨害公務,38,33,5
105,50-59歲嫌犯數,違反著作權法,15,11,4
105,50-59歲嫌犯數,違反商標法,5,2,3
105,50-59歲嫌犯數,妨害電腦使用,8,5,3
105,50-59歲嫌犯數,強盜搶奪總計,10,9,1
105,50-59歲嫌犯數,強盜,6,5,1
105,50-59歲嫌犯數,搶奪,4,4,0
105,50-59歲嫌犯數,竊佔,18,11,7
105,50-59歲嫌犯數,偽造有價證券,3,1,2
105,50-59歲嫌犯數,妨害秩序,2,1,1
105,50-59歲嫌犯數,違反藥事法,2,2,0
105,50-59歲嫌犯數,違反國家總動員法,0,0,0
105,50-59歲嫌犯數,違反森林法,1,1,0
105,50-59歲嫌犯數,公共危險,1321,1218,103
105,50-59歲嫌犯數,侵害墳墓屍體,0,0,0
105,50-59歲嫌犯數,重利,8,4,4
105,50-59歲嫌犯數,妨害名譽,67,44,23
105,50-59歲嫌犯數,違反選罷法,3,2,1
105,50-59歲嫌犯數,妨害祕密,3,2,1
105,50-59歲嫌犯數,遺棄,4,3,1
105,50-59歲嫌犯數,違反貪污治罪條例,0,0,0
105,50-59歲嫌犯數,懲治走私條例,0,0,0
105,50-59歲嫌犯數,妨害兵役,0,0,0
105,50-59歲嫌犯數,偽造貨幣,1,0,1
105,50-59歲嫌犯數,偽造度量衡,0,0,0
105,50-59歲嫌犯數,偽證,0,0,0
105,50-59歲嫌犯數,誣告,13,9,4
105,50-59歲嫌犯數,湮滅證據,0,0,0
105,50-59歲嫌犯數,瀆職,0,0,0
105,50-59歲嫌犯數,脫逃,1,1,0
105,50-59歲嫌犯數,藏匿頂替,1,0,1
105,50-59歲嫌犯數,違反槍砲彈藥刀械管制條例,8,8,0
105,50-59歲嫌犯數,違反就業服務法,0,0,0
105,50-59歲嫌犯數,其他,97,84,13
105,60-64歲嫌犯數,總計,1145,929,216
105,60-64歲嫌犯數,竊盜總計,152,108,44
105,60-64歲嫌犯數,重大竊盜,1,0,1
105,60-64歲嫌犯數,普通竊盜,143,101,42
105,60-64歲嫌犯數,汽車竊盜,1,1,0
105,60-64歲嫌犯數,機車竊盜,7,6,1
105,60-64歲嫌犯數,贓物,1,1,0
105,60-64歲嫌犯數,賭博,231,168,63
105,60-64歲嫌犯數,傷害總計,69,58,11
105,60-64歲嫌犯數,重傷害,0,0,0
105,60-64歲嫌犯數,一般傷害,69,58,11
105,60-64歲嫌犯數,詐欺背信總計,32,26,6
105,60-64歲嫌犯數,詐欺,27,21,6
105,60-64歲嫌犯數,背信,5,5,0
105,60-64歲嫌犯數,妨害自由,52,42,10
105,60-64歲嫌犯數,殺人總計,3,3,0
105,60-64歲嫌犯數,故意殺人,3,3,0
105,60-64歲嫌犯數,過失致死,0,0,0
105,60-64歲嫌犯數,駕駛過失,71,59,12
105,60-64歲嫌犯數,妨害婚姻及家庭,1,1,0
105,60-64歲嫌犯數,妨害風化,3,1,2
105,60-64歲嫌犯數,妨害性自主罪總計,13,12,1
105,60-64歲嫌犯數,強制性交,0,0,0
105,60-64歲嫌犯數,共同強制性交,0,0,0
105,60-64歲嫌犯數,對幼性交,0,0,0
105,60-64歲嫌犯數,性交猥褻,13,12,1
105,60-64歲嫌犯數,內亂,0,0,0
105,60-64歲嫌犯數,恐嚇取財總計,0,0,0
105,60-64歲嫌犯數,重大恐嚇取財,0,0,0
105,60-64歲嫌犯數,一般恐嚇取財,0,0,0
105,60-64歲嫌犯數,擄人勒贖,0,0,0
105,60-64歲嫌犯數,侵占,12,11,1
105,60-64歲嫌犯數,偽造文書印文,10,5,5
105,60-64歲嫌犯數,違反毒品危害防制條例總計,82,75,7
105,60-64歲嫌犯數,第一級毒品,36,34,2
105,60-64歲嫌犯數,第二級毒品,46,41,5
105,60-64歲嫌犯數,第三級毒品,0,0,0
105,60-64歲嫌犯數,第四級毒品,0,0,0
105,60-64歲嫌犯數,其他,0,0,0
105,60-64歲嫌犯數,毀棄損壞,19,12,7
105,60-64歲嫌犯數,妨害公務,8,7,1
105,60-64歲嫌犯數,違反著作權法,8,6,2
105,60-64歲嫌犯數,違反商標法,0,0,0
105,60-64歲嫌犯數,妨害電腦使用,1,1,0
105,60-64歲嫌犯數,強盜搶奪總計,0,0,0
105,60-64歲嫌犯數,強盜,0,0,0
105,60-64歲嫌犯數,搶奪,0,0,0
105,60-64歲嫌犯數,竊佔,8,5,3
105,60-64歲嫌犯數,偽造有價證券,0,0,0
105,60-64歲嫌犯數,妨害秩序,0,0,0
105,60-64歲嫌犯數,違反藥事法,0,0,0
105,60-64歲嫌犯數,違反國家總動員法,0,0,0
105,60-64歲嫌犯數,違反森林法,0,0,0
105,60-64歲嫌犯數,公共危險,301,280,21
105,60-64歲嫌犯數,侵害墳墓屍體,1,1,0
105,60-64歲嫌犯數,重利,0,0,0
105,60-64歲嫌犯數,妨害名譽,29,17,12
105,60-64歲嫌犯數,違反選罷法,3,1,2
105,60-64歲嫌犯數,妨害祕密,3,3,0
105,60-64歲嫌犯數,遺棄,2,1,1
105,60-64歲嫌犯數,違反貪污治罪條例,0,0,0
105,60-64歲嫌犯數,懲治走私條例,0,0,0
105,60-64歲嫌犯數,妨害兵役,0,0,0
105,60-64歲嫌犯數,偽造貨幣,0,0,0
105,60-64歲嫌犯數,偽造度量衡,0,0,0
105,60-64歲嫌犯數,偽證,0,0,0
105,60-64歲嫌犯數,誣告,0,0,0
105,60-64歲嫌犯數,湮滅證據,0,0,0
105,60-64歲嫌犯數,瀆職,0,0,0
105,60-64歲嫌犯數,脫逃,0,0,0
105,60-64歲嫌犯數,藏匿頂替,0,0,0
105,60-64歲嫌犯數,違反槍砲彈藥刀械管制條例,3,3,0
105,60-64歲嫌犯數,違反就業服務法,0,0,0
105,60-64歲嫌犯數,其他,27,22,5
105,65-69歲嫌犯數,總計,612,473,139
105,65-69歲嫌犯數,竊盜總計,97,53,44
105,65-69歲嫌犯數,重大竊盜,0,0,0
105,65-69歲嫌犯數,普通竊盜,92,48,44
105,65-69歲嫌犯數,汽車竊盜,0,0,0
105,65-69歲嫌犯數,機車竊盜,5,5,0
105,65-69歲嫌犯數,贓物,0,0,0
105,65-69歲嫌犯數,賭博,154,109,45
105,65-69歲嫌犯數,傷害總計,32,26,6
105,65-69歲嫌犯數,重傷害,0,0,0
105,65-69歲嫌犯數,一般傷害,32,26,6
105,65-69歲嫌犯數,詐欺背信總計,17,9,8
105,65-69歲嫌犯數,詐欺,14,8,6
105,65-69歲嫌犯數,背信,3,1,2
105,65-69歲嫌犯數,妨害自由,16,13,3
105,65-69歲嫌犯數,殺人總計,2,1,1
105,65-69歲嫌犯數,故意殺人,2,1,1
105,65-69歲嫌犯數,過失致死,0,0,0
105,65-69歲嫌犯數,駕駛過失,27,24,3
105,65-69歲嫌犯數,妨害婚姻及家庭,1,1,0
105,65-69歲嫌犯數,妨害風化,2,1,1
105,65-69歲嫌犯數,妨害性自主罪總計,6,6,0
105,65-69歲嫌犯數,強制性交,0,0,0
105,65-69歲嫌犯數,共同強制性交,0,0,0
105,65-69歲嫌犯數,對幼性交,0,0,0
105,65-69歲嫌犯數,性交猥褻,6,6,0
105,65-69歲嫌犯數,內亂,0,0,0
105,65-69歲嫌犯數,恐嚇取財總計,1,1,0
105,65-69歲嫌犯數,重大恐嚇取財,0,0,0
105,65-69歲嫌犯數,一般恐嚇取財,1,1,0
105,65-69歲嫌犯數,擄人勒贖,0,0,0
105,65-69歲嫌犯數,侵占,12,9,3
105,65-69歲嫌犯數,偽造文書印文,3,3,0
105,65-69歲嫌犯數,違反毒品危害防制條例總計,37,36,1
105,65-69歲嫌犯數,第一級毒品,15,15,0
105,65-69歲嫌犯數,第二級毒品,21,20,1
105,65-69歲嫌犯數,第三級毒品,1,1,0
105,65-69歲嫌犯數,第四級毒品,0,0,0
105,65-69歲嫌犯數,其他,0,0,0
105,65-69歲嫌犯數,毀棄損壞,10,9,1
105,65-69歲嫌犯數,妨害公務,3,2,1
105,65-69歲嫌犯數,違反著作權法,2,2,0
105,65-69歲嫌犯數,違反商標法,1,1,0
105,65-69歲嫌犯數,妨害電腦使用,1,0,1
105,65-69歲嫌犯數,強盜搶奪總計,0,0,0
105,65-69歲嫌犯數,強盜,0,0,0
105,65-69歲嫌犯數,搶奪,0,0,0
105,65-69歲嫌犯數,竊佔,4,3,1
105,65-69歲嫌犯數,偽造有價證券,1,1,0
105,65-69歲嫌犯數,妨害秩序,1,1,0
105,65-69歲嫌犯數,違反藥事法,1,0,1
105,65-69歲嫌犯數,違反國家總動員法,0,0,0
105,65-69歲嫌犯數,違反森林法,0,0,0
105,65-69歲嫌犯數,公共危險,147,137,10
105,65-69歲嫌犯數,侵害墳墓屍體,0,0,0
105,65-69歲嫌犯數,重利,1,0,1
105,65-69歲嫌犯數,妨害名譽,13,8,5
105,65-69歲嫌犯數,違反選罷法,2,2,0
105,65-69歲嫌犯數,妨害祕密,0,0,0
105,65-69歲嫌犯數,遺棄,1,1,0
105,65-69歲嫌犯數,違反貪污治罪條例,0,0,0
105,65-69歲嫌犯數,懲治走私條例,0,0,0
105,65-69歲嫌犯數,妨害兵役,0,0,0
105,65-69歲嫌犯數,偽造貨幣,0,0,0
105,65-69歲嫌犯數,偽造度量衡,0,0,0
105,65-69歲嫌犯數,偽證,0,0,0
105,65-69歲嫌犯數,誣告,0,0,0
105,65-69歲嫌犯數,湮滅證據,0,0,0
105,65-69歲嫌犯數,瀆職,0,0,0
105,65-69歲嫌犯數,脫逃,0,0,0
105,65-69歲嫌犯數,藏匿頂替,0,0,0
105,65-69歲嫌犯數,違反槍砲彈藥刀械管制條例,0,0,0
105,65-69歲嫌犯數,違反就業服務法,0,0,0
105,65-69歲嫌犯數,其他,17,14,3
105,70歲以上嫌犯數,總計,506,366,140
105,70歲以上嫌犯數,竊盜總計,130,68,62
105,70歲以上嫌犯數,重大竊盜,0,0,0
105,70歲以上嫌犯數,普通竊盜,129,67,62
105,70歲以上嫌犯數,汽車竊盜,0,0,0
105,70歲以上嫌犯數,機車竊盜,1,1,0
105,70歲以上嫌犯數,贓物,1,1,0
105,70歲以上嫌犯數,賭博,135,94,41
105,70歲以上嫌犯數,傷害總計,33,26,7
105,70歲以上嫌犯數,重傷害,0,0,0
105,70歲以上嫌犯數,一般傷害,33,26,7
105,70歲以上嫌犯數,詐欺背信總計,23,21,2
105,70歲以上嫌犯數,詐欺,18,16,2
105,70歲以上嫌犯數,背信,5,5,0
105,70歲以上嫌犯數,妨害自由,19,13,6
105,70歲以上嫌犯數,殺人總計,1,0,1
105,70歲以上嫌犯數,故意殺人,0,0,0
105,70歲以上嫌犯數,過失致死,1,0,1
105,70歲以上嫌犯數,駕駛過失,33,29,4
105,70歲以上嫌犯數,妨害婚姻及家庭,0,0,0
105,70歲以上嫌犯數,妨害風化,4,3,1
105,70歲以上嫌犯數,妨害性自主罪總計,4,4,0
105,70歲以上嫌犯數,強制性交,0,0,0
105,70歲以上嫌犯數,共同強制性交,0,0,0
105,70歲以上嫌犯數,對幼性交,0,0,0
105,70歲以上嫌犯數,性交猥褻,4,4,0
105,70歲以上嫌犯數,內亂,0,0,0
105,70歲以上嫌犯數,恐嚇取財總計,0,0,0
105,70歲以上嫌犯數,重大恐嚇取財,0,0,0
105,70歲以上嫌犯數,一般恐嚇取財,0,0,0
105,70歲以上嫌犯數,擄人勒贖,0,0,0
105,70歲以上嫌犯數,侵占,8,7,1
105,70歲以上嫌犯數,偽造文書印文,3,3,0
105,70歲以上嫌犯數,違反毒品危害防制條例總計,9,9,0
105,70歲以上嫌犯數,第一級毒品,5,5,0
105,70歲以上嫌犯數,第二級毒品,4,4,0
105,70歲以上嫌犯數,第三級毒品,0,0,0
105,70歲以上嫌犯數,第四級毒品,0,0,0
105,70歲以上嫌犯數,其他,0,0,0
105,70歲以上嫌犯數,毀棄損壞,4,4,0
105,70歲以上嫌犯數,妨害公務,1,1,0
105,70歲以上嫌犯數,違反著作權法,0,0,0
105,70歲以上嫌犯數,違反商標法,0,0,0
105,70歲以上嫌犯數,妨害電腦使用,0,0,0
105,70歲以上嫌犯數,強盜搶奪總計,0,0,0
105,70歲以上嫌犯數,強盜,0,0,0
105,70歲以上嫌犯數,搶奪,0,0,0
105,70歲以上嫌犯數,竊佔,4,0,4
105,70歲以上嫌犯數,偽造有價證券,0,0,0
105,70歲以上嫌犯數,妨害秩序,0,0,0
105,70歲以上嫌犯數,違反藥事法,0,0,0
105,70歲以上嫌犯數,違反國家總動員法,0,0,0
105,70歲以上嫌犯數,違反森林法,0,0,0
105,70歲以上嫌犯數,公共危險,54,52,2
105,70歲以上嫌犯數,侵害墳墓屍體,0,0,0
105,70歲以上嫌犯數,重利,0,0,0
105,70歲以上嫌犯數,妨害名譽,8,7,1
105,70歲以上嫌犯數,違反選罷法,5,4,1
105,70歲以上嫌犯數,妨害祕密,1,1,0
105,70歲以上嫌犯數,遺棄,0,0,0
105,70歲以上嫌犯數,違反貪污治罪條例,0,0,0
105,70歲以上嫌犯數,懲治走私條例,0,0,0
105,70歲以上嫌犯數,妨害兵役,0,0,0
105,70歲以上嫌犯數,偽造貨幣,0,0,0
105,70歲以上嫌犯數,偽造度量衡,0,0,0
105,70歲以上嫌犯數,偽證,0,0,0
105,70歲以上嫌犯數,誣告,4,2,2
105,70歲以上嫌犯數,湮滅證據,0,0,0
105,70歲以上嫌犯數,瀆職,0,0,0
105,70歲以上嫌犯數,脫逃,0,0,0
105,70歲以上嫌犯數,藏匿頂替,0,0,0
105,70歲以上嫌犯數,違反槍砲彈藥刀械管制條例,0,0,0
105,70歲以上嫌犯數,違反就業服務法,0,0,0
105,70歲以上嫌犯數,其他,22,17,5
105,年齡不詳嫌犯數,總計,1,1,0
105,年齡不詳嫌犯數,竊盜總計,0,0,0
105,年齡不詳嫌犯數,重大竊盜,0,0,0
105,年齡不詳嫌犯數,普通竊盜,0,0,0
105,年齡不詳嫌犯數,汽車竊盜,0,0,0
105,年齡不詳嫌犯數,機車竊盜,0,0,0
105,年齡不詳嫌犯數,贓物,0,0,0
105,年齡不詳嫌犯數,賭博,0,0,0
105,年齡不詳嫌犯數,傷害總計,0,0,0
105,年齡不詳嫌犯數,重傷害,0,0,0
105,年齡不詳嫌犯數,一般傷害,0,0,0
105,年齡不詳嫌犯數,詐欺背信總計,0,0,0
105,年齡不詳嫌犯數,詐欺,0,0,0
105,年齡不詳嫌犯數,背信,0,0,0
105,年齡不詳嫌犯數,妨害自由,0,0,0
105,年齡不詳嫌犯數,殺人總計,0,0,0
105,年齡不詳嫌犯數,故意殺人,0,0,0
105,年齡不詳嫌犯數,過失致死,0,0,0
105,年齡不詳嫌犯數,駕駛過失,0,0,0
105,年齡不詳嫌犯數,妨害婚姻及家庭,0,0,0
105,年齡不詳嫌犯數,妨害風化,0,0,0
105,年齡不詳嫌犯數,妨害性自主罪總計,0,0,0
105,年齡不詳嫌犯數,強制性交,0,0,0
105,年齡不詳嫌犯數,共同強制性交,0,0,0
105,年齡不詳嫌犯數,對幼性交,0,0,0
105,年齡不詳嫌犯數,性交猥褻,0,0,0
105,年齡不詳嫌犯數,內亂,0,0,0
105,年齡不詳嫌犯數,恐嚇取財總計,0,0,0
105,年齡不詳嫌犯數,重大恐嚇取財,0,0,0
105,年齡不詳嫌犯數,一般恐嚇取財,0,0,0
105,年齡不詳嫌犯數,擄人勒贖,0,0,0
105,年齡不詳嫌犯數,侵占,0,0,0
105,年齡不詳嫌犯數,偽造文書印文,0,0,0
105,年齡不詳嫌犯數,違反毒品危害防制條例總計,0,0,0
105,年齡不詳嫌犯數,第一級毒品,0,0,0
105,年齡不詳嫌犯數,第二級毒品,0,0,0
105,年齡不詳嫌犯數,第三級毒品,0,0,0
105,年齡不詳嫌犯數,第四級毒品,0,0,0
105,年齡不詳嫌犯數,其他,0,0,0
105,年齡不詳嫌犯數,毀棄損壞,0,0,0
105,年齡不詳嫌犯數,妨害公務,0,0,0
105,年齡不詳嫌犯數,違反著作權法,0,0,0
105,年齡不詳嫌犯數,違反商標法,0,0,0
105,年齡不詳嫌犯數,妨害電腦使用,0,0,0
105,年齡不詳嫌犯數,強盜搶奪總計,1,1,0
105,年齡不詳嫌犯數,強盜,0,0,0
105,年齡不詳嫌犯數,搶奪,1,1,0
105,年齡不詳嫌犯數,竊佔,0,0,0
105,年齡不詳嫌犯數,偽造有價證券,0,0,0
105,年齡不詳嫌犯數,妨害秩序,0,0,0
105,年齡不詳嫌犯數,違反藥事法,0,0,0
105,年齡不詳嫌犯數,違反國家總動員法,0,0,0
105,年齡不詳嫌犯數,違反森林法,0,0,0
105,年齡不詳嫌犯數,公共危險,0,0,0
105,年齡不詳嫌犯數,侵害墳墓屍體,0,0,0
105,年齡不詳嫌犯數,重利,0,0,0
105,年齡不詳嫌犯數,妨害名譽,0,0,0
105,年齡不詳嫌犯數,違反選罷法,0,0,0
105,年齡不詳嫌犯數,妨害祕密,0,0,0
105,年齡不詳嫌犯數,遺棄,0,0,0
105,年齡不詳嫌犯數,違反貪污治罪條例,0,0,0
105,年齡不詳嫌犯數,懲治走私條例,0,0,0
105,年齡不詳嫌犯數,妨害兵役,0,0,0
105,年齡不詳嫌犯數,偽造貨幣,0,0,0
105,年齡不詳嫌犯數,偽造度量衡,0,0,0
105,年齡不詳嫌犯數,偽證,0,0,0
105,年齡不詳嫌犯數,誣告,0,0,0
105,年齡不詳嫌犯數,湮滅證據,0,0,0
105,年齡不詳嫌犯數,瀆職,0,0,0
105,年齡不詳嫌犯數,脫逃,0,0,0
105,年齡不詳嫌犯數,藏匿頂替,0,0,0
105,年齡不詳嫌犯數,違反槍砲彈藥刀械管制條例,0,0,0
105,年齡不詳嫌犯數,違反就業服務法,0,0,0
105,年齡不詳嫌犯數,其他,0,0,0
106,總計,總計,37758,31275,6483
106,總計,竊盜總計,4736,3702,1034
106,總計,重大竊盜,4,4,0
106,總計,普通竊盜,4082,3095,987
106,總計,汽車竊盜,153,145,8
106,總計,機車竊盜,497,458,39
106,總計,贓物,28,24,4
106,總計,賭博,1282,958,324
106,總計,傷害總計,1599,1356,243
106,總計,重傷害,1,1,0
106,總計,一般傷害,1598,1355,243
106,總計,詐欺背信總計,2816,2095,721
106,總計,詐欺,2727,2037,690
106,總計,背信,89,58,31
106,總計,妨害自由,1159,960,199
106,總計,殺人總計,67,61,6
106,總計,故意殺人,63,59,4
106,總計,過失致死,4,2,2
106,總計,駕駛過失,1036,846,190
106,總計,妨害婚姻及家庭,101,62,39
106,總計,妨害風化,164,103,61
106,總計,妨害性自主罪總計,470,465,5
106,總計,強制性交,37,37,0
106,總計,共同強制性交,0,0,0
106,總計,對幼性交,7,7,0
106,總計,性交猥褻,426,421,5
106,總計,內亂,0,0,0
106,總計,恐嚇取財總計,117,104,13
106,總計,重大恐嚇取財,0,0,0
106,總計,一般恐嚇取財,117,104,13
106,總計,擄人勒贖,0,0,0
106,總計,侵占,505,334,171
106,總計,偽造文書印文,355,251,104
106,總計,違反毒品危害防制條例總計,12167,10446,1721
106,總計,第一級毒品,1848,1553,295
106,總計,第二級毒品,9622,8266,1356
106,總計,第三級毒品,694,624,70
106,總計,第四級毒品,1,1,0
106,總計,其他,2,2,0
106,總計,毀棄損壞,385,324,61
106,總計,妨害公務,316,287,29
106,總計,違反著作權法,160,127,33
106,總計,違反商標法,38,14,24
106,總計,妨害電腦使用,89,65,24
106,總計,強盜搶奪總計,97,86,11
106,總計,強盜,69,59,10
106,總計,搶奪,28,27,1
106,總計,竊佔,66,52,14
106,總計,偽造有價證券,16,11,5
106,總計,妨害秩序,466,436,30
106,總計,違反藥事法,14,7,7
106,總計,違反國家總動員法,0,0,0
106,總計,違反森林法,8,8,0
106,總計,公共危險,6295,5761,534
106,總計,侵害墳墓屍體,1,1,0
106,總計,重利,215,204,11
106,總計,妨害名譽,750,503,247
106,總計,違反選罷法,0,0,0
106,總計,妨害祕密,61,51,10
106,總計,遺棄,22,6,16
106,總計,違反貪污治罪條例,0,0,0
106,總計,懲治走私條例,0,0,0
106,總計,妨害兵役,0,0,0
106,總計,偽造貨幣,2,2,0
106,總計,偽造度量衡,0,0,0
106,總計,偽證,0,0,0
106,總計,誣告,34,21,13
106,總計,湮滅證據,1,1,0
106,總計,瀆職,0,0,0
106,總計,脫逃,4,2,2
106,總計,藏匿頂替,7,5,2
106,總計,違反槍砲彈藥刀械管制條例,258,241,17
106,總計,違反就業服務法,1,0,1
106,總計,其他,1850,1293,557
106,00-05歲嫌犯數,總計,1,1,0
106,00-05歲嫌犯數,竊盜總計,0,0,0
106,00-05歲嫌犯數,重大竊盜,0,0,0
106,00-05歲嫌犯數,普通竊盜,0,0,0
106,00-05歲嫌犯數,汽車竊盜,0,0,0
106,00-05歲嫌犯數,機車竊盜,0,0,0
106,00-05歲嫌犯數,贓物,0,0,0
106,00-05歲嫌犯數,賭博,0,0,0
106,00-05歲嫌犯數,傷害總計,0,0,0
106,00-05歲嫌犯數,重傷害,0,0,0
106,00-05歲嫌犯數,一般傷害,0,0,0
106,00-05歲嫌犯數,詐欺背信總計,0,0,0
106,00-05歲嫌犯數,詐欺,0,0,0
106,00-05歲嫌犯數,背信,0,0,0
106,00-05歲嫌犯數,妨害自由,0,0,0
106,00-05歲嫌犯數,殺人總計,0,0,0
106,00-05歲嫌犯數,故意殺人,0,0,0
106,00-05歲嫌犯數,過失致死,0,0,0
106,00-05歲嫌犯數,駕駛過失,0,0,0
106,00-05歲嫌犯數,妨害婚姻及家庭,0,0,0
106,00-05歲嫌犯數,妨害風化,0,0,0
106,00-05歲嫌犯數,妨害性自主罪總計,1,1,0
106,00-05歲嫌犯數,強制性交,0,0,0
106,00-05歲嫌犯數,共同強制性交,0,0,0
106,00-05歲嫌犯數,對幼性交,0,0,0
106,00-05歲嫌犯數,性交猥褻,1,1,0
106,00-05歲嫌犯數,內亂,0,0,0
106,00-05歲嫌犯數,恐嚇取財總計,0,0,0
106,00-05歲嫌犯數,重大恐嚇取財,0,0,0
106,00-05歲嫌犯數,一般恐嚇取財,0,0,0
106,00-05歲嫌犯數,擄人勒贖,0,0,0
106,00-05歲嫌犯數,侵占,0,0,0
106,00-05歲嫌犯數,偽造文書印文,0,0,0
106,00-05歲嫌犯數,違反毒品危害防制條例總計,0,0,0
106,00-05歲嫌犯數,第一級毒品,0,0,0
106,00-05歲嫌犯數,第二級毒品,0,0,0
106,00-05歲嫌犯數,第三級毒品,0,0,0
106,00-05歲嫌犯數,第四級毒品,0,0,0
106,00-05歲嫌犯數,其他,0,0,0
106,00-05歲嫌犯數,毀棄損壞,0,0,0
106,00-05歲嫌犯數,妨害公務,0,0,0
106,00-05歲嫌犯數,違反著作權法,0,0,0
106,00-05歲嫌犯數,違反商標法,0,0,0
106,00-05歲嫌犯數,妨害電腦使用,0,0,0
106,00-05歲嫌犯數,強盜搶奪總計,0,0,0
106,00-05歲嫌犯數,強盜,0,0,0
106,00-05歲嫌犯數,搶奪,0,0,0
106,00-05歲嫌犯數,竊佔,0,0,0
106,00-05歲嫌犯數,偽造有價證券,0,0,0
106,00-05歲嫌犯數,妨害秩序,0,0,0
106,00-05歲嫌犯數,違反藥事法,0,0,0
106,00-05歲嫌犯數,違反國家總動員法,0,0,0
106,00-05歲嫌犯數,違反森林法,0,0,0
106,00-05歲嫌犯數,公共危險,0,0,0
106,00-05歲嫌犯數,侵害墳墓屍體,0,0,0
106,00-05歲嫌犯數,重利,0,0,0
106,00-05歲嫌犯數,妨害名譽,0,0,0
106,00-05歲嫌犯數,違反選罷法,0,0,0
106,00-05歲嫌犯數,妨害祕密,0,0,0
106,00-05歲嫌犯數,遺棄,0,0,0
106,00-05歲嫌犯數,違反貪污治罪條例,0,0,0
106,00-05歲嫌犯數,懲治走私條例,0,0,0
106,00-05歲嫌犯數,妨害兵役,0,0,0
106,00-05歲嫌犯數,偽造貨幣,0,0,0
106,00-05歲嫌犯數,偽造度量衡,0,0,0
106,00-05歲嫌犯數,偽證,0,0,0
106,00-05歲嫌犯數,誣告,0,0,0
106,00-05歲嫌犯數,湮滅證據,0,0,0
106,00-05歲嫌犯數,瀆職,0,0,0
106,00-05歲嫌犯數,脫逃,0,0,0
106,00-05歲嫌犯數,藏匿頂替,0,0,0
106,00-05歲嫌犯數,違反槍砲彈藥刀械管制條例,0,0,0
106,00-05歲嫌犯數,違反就業服務法,0,0,0
106,00-05歲嫌犯數,其他,0,0,0
106,6-11歲嫌犯數,總計,70,58,12
106,6-11歲嫌犯數,竊盜總計,52,43,9
106,6-11歲嫌犯數,重大竊盜,0,0,0
106,6-11歲嫌犯數,普通竊盜,51,42,9
106,6-11歲嫌犯數,汽車竊盜,0,0,0
106,6-11歲嫌犯數,機車竊盜,1,1,0
106,6-11歲嫌犯數,贓物,1,1,0
106,6-11歲嫌犯數,賭博,0,0,0
106,6-11歲嫌犯數,傷害總計,9,8,1
106,6-11歲嫌犯數,重傷害,0,0,0
106,6-11歲嫌犯數,一般傷害,9,8,1
106,6-11歲嫌犯數,詐欺背信總計,0,0,0
106,6-11歲嫌犯數,詐欺,0,0,0
106,6-11歲嫌犯數,背信,0,0,0
106,6-11歲嫌犯數,妨害自由,0,0,0
106,6-11歲嫌犯數,殺人總計,0,0,0
106,6-11歲嫌犯數,故意殺人,0,0,0
106,6-11歲嫌犯數,過失致死,0,0,0
106,6-11歲嫌犯數,駕駛過失,3,2,1
106,6-11歲嫌犯數,妨害婚姻及家庭,0,0,0
106,6-11歲嫌犯數,妨害風化,0,0,0
106,6-11歲嫌犯數,妨害性自主罪總計,2,2,0
106,6-11歲嫌犯數,強制性交,0,0,0
106,6-11歲嫌犯數,共同強制性交,0,0,0
106,6-11歲嫌犯數,對幼性交,0,0,0
106,6-11歲嫌犯數,性交猥褻,2,2,0
106,6-11歲嫌犯數,內亂,0,0,0
106,6-11歲嫌犯數,恐嚇取財總計,0,0,0
106,6-11歲嫌犯數,重大恐嚇取財,0,0,0
106,6-11歲嫌犯數,一般恐嚇取財,0,0,0
106,6-11歲嫌犯數,擄人勒贖,0,0,0
106,6-11歲嫌犯數,侵占,1,0,1
106,6-11歲嫌犯數,偽造文書印文,0,0,0
106,6-11歲嫌犯數,違反毒品危害防制條例總計,0,0,0
106,6-11歲嫌犯數,第一級毒品,0,0,0
106,6-11歲嫌犯數,第二級毒品,0,0,0
106,6-11歲嫌犯數,第三級毒品,0,0,0
106,6-11歲嫌犯數,第四級毒品,0,0,0
106,6-11歲嫌犯數,其他,0,0,0
106,6-11歲嫌犯數,毀棄損壞,1,1,0
106,6-11歲嫌犯數,妨害公務,0,0,0
106,6-11歲嫌犯數,違反著作權法,0,0,0
106,6-11歲嫌犯數,違反商標法,0,0,0
106,6-11歲嫌犯數,妨害電腦使用,0,0,0
106,6-11歲嫌犯數,強盜搶奪總計,0,0,0
106,6-11歲嫌犯數,強盜,0,0,0
106,6-11歲嫌犯數,搶奪,0,0,0
106,6-11歲嫌犯數,竊佔,0,0,0
106,6-11歲嫌犯數,偽造有價證券,0,0,0
106,6-11歲嫌犯數,妨害秩序,0,0,0
106,6-11歲嫌犯數,違反藥事法,0,0,0
106,6-11歲嫌犯數,違反國家總動員法,0,0,0
106,6-11歲嫌犯數,違反森林法,0,0,0
106,6-11歲嫌犯數,公共危險,0,0,0
106,6-11歲嫌犯數,侵害墳墓屍體,0,0,0
106,6-11歲嫌犯數,重利,0,0,0
106,6-11歲嫌犯數,妨害名譽,0,0,0
106,6-11歲嫌犯數,違反選罷法,0,0,0
106,6-11歲嫌犯數,妨害祕密,0,0,0
106,6-11歲嫌犯數,遺棄,0,0,0
106,6-11歲嫌犯數,違反貪污治罪條例,0,0,0
106,6-11歲嫌犯數,懲治走私條例,0,0,0
106,6-11歲嫌犯數,妨害兵役,0,0,0
106,6-11歲嫌犯數,偽造貨幣,0,0,0
106,6-11歲嫌犯數,偽造度量衡,0,0,0
106,6-11歲嫌犯數,偽證,0,0,0
106,6-11歲嫌犯數,誣告,0,0,0
106,6-11歲嫌犯數,湮滅證據,0,0,0
106,6-11歲嫌犯數,瀆職,0,0,0
106,6-11歲嫌犯數,脫逃,0,0,0
106,6-11歲嫌犯數,藏匿頂替,0,0,0
106,6-11歲嫌犯數,違反槍砲彈藥刀械管制條例,0,0,0
106,6-11歲嫌犯數,違反就業服務法,0,0,0
106,6-11歲嫌犯數,其他,1,1,0
106,12-17歲嫌犯數,總計,1776,1499,277
106,12-17歲嫌犯數,竊盜總計,270,219,51
106,12-17歲嫌犯數,重大竊盜,0,0,0
106,12-17歲嫌犯數,普通竊盜,204,158,46
106,12-17歲嫌犯數,汽車竊盜,4,3,1
106,12-17歲嫌犯數,機車竊盜,62,58,4
106,12-17歲嫌犯數,贓物,3,2,1
106,12-17歲嫌犯數,賭博,59,56,3
106,12-17歲嫌犯數,傷害總計,108,101,7
106,12-17歲嫌犯數,重傷害,0,0,0
106,12-17歲嫌犯數,一般傷害,108,101,7
106,12-17歲嫌犯數,詐欺背信總計,185,159,26
106,12-17歲嫌犯數,詐欺,183,158,25
106,12-17歲嫌犯數,背信,2,1,1
106,12-17歲嫌犯數,妨害自由,56,50,6
106,12-17歲嫌犯數,殺人總計,12,12,0
106,12-17歲嫌犯數,故意殺人,12,12,0
106,12-17歲嫌犯數,過失致死,0,0,0
106,12-17歲嫌犯數,駕駛過失,23,19,4
106,12-17歲嫌犯數,妨害婚姻及家庭,5,5,0
106,12-17歲嫌犯數,妨害風化,0,0,0
106,12-17歲嫌犯數,妨害性自主罪總計,87,86,1
106,12-17歲嫌犯數,強制性交,4,4,0
106,12-17歲嫌犯數,共同強制性交,0,0,0
106,12-17歲嫌犯數,對幼性交,2,2,0
106,12-17歲嫌犯數,性交猥褻,81,80,1
106,12-17歲嫌犯數,內亂,0,0,0
106,12-17歲嫌犯數,恐嚇取財總計,7,7,0
106,12-17歲嫌犯數,重大恐嚇取財,0,0,0
106,12-17歲嫌犯數,一般恐嚇取財,7,7,0
106,12-17歲嫌犯數,擄人勒贖,0,0,0
106,12-17歲嫌犯數,侵占,9,6,3
106,12-17歲嫌犯數,偽造文書印文,5,3,2
106,12-17歲嫌犯數,違反毒品危害防制條例總計,579,459,120
106,12-17歲嫌犯數,第一級毒品,3,1,2
106,12-17歲嫌犯數,第二級毒品,395,305,90
106,12-17歲嫌犯數,第三級毒品,181,153,28
106,12-17歲嫌犯數,第四級毒品,0,0,0
106,12-17歲嫌犯數,其他,0,0,0
106,12-17歲嫌犯數,毀棄損壞,14,13,1
106,12-17歲嫌犯數,妨害公務,11,9,2
106,12-17歲嫌犯數,違反著作權法,0,0,0
106,12-17歲嫌犯數,違反商標法,0,0,0
106,12-17歲嫌犯數,妨害電腦使用,8,8,0
106,12-17歲嫌犯數,強盜搶奪總計,2,2,0
106,12-17歲嫌犯數,強盜,1,1,0
106,12-17歲嫌犯數,搶奪,1,1,0
106,12-17歲嫌犯數,竊佔,0,0,0
106,12-17歲嫌犯數,偽造有價證券,0,0,0
106,12-17歲嫌犯數,妨害秩序,108,97,11
106,12-17歲嫌犯數,違反藥事法,0,0,0
106,12-17歲嫌犯數,違反國家總動員法,0,0,0
106,12-17歲嫌犯數,違反森林法,0,0,0
106,12-17歲嫌犯數,公共危險,77,68,9
106,12-17歲嫌犯數,侵害墳墓屍體,1,1,0
106,12-17歲嫌犯數,重利,1,1,0
106,12-17歲嫌犯數,妨害名譽,44,31,13
106,12-17歲嫌犯數,違反選罷法,0,0,0
106,12-17歲嫌犯數,妨害祕密,0,0,0
106,12-17歲嫌犯數,遺棄,2,1,1
106,12-17歲嫌犯數,違反貪污治罪條例,0,0,0
106,12-17歲嫌犯數,懲治走私條例,0,0,0
106,12-17歲嫌犯數,妨害兵役,0,0,0
106,12-17歲嫌犯數,偽造貨幣,0,0,0
106,12-17歲嫌犯數,偽造度量衡,0,0,0
106,12-17歲嫌犯數,偽證,0,0,0
106,12-17歲嫌犯數,誣告,0,0,0
106,12-17歲嫌犯數,湮滅證據,0,0,0
106,12-17歲嫌犯數,瀆職,0,0,0
106,12-17歲嫌犯數,脫逃,0,0,0
106,12-17歲嫌犯數,藏匿頂替,0,0,0
106,12-17歲嫌犯數,違反槍砲彈藥刀械管制條例,8,7,1
106,12-17歲嫌犯數,違反就業服務法,0,0,0
106,12-17歲嫌犯數,其他,92,77,15
106,18-23歲嫌犯數,總計,5310,4485,825
106,18-23歲嫌犯數,竊盜總計,327,276,51
106,18-23歲嫌犯數,重大竊盜,0,0,0
106,18-23歲嫌犯數,普通竊盜,258,213,45
106,18-23歲嫌犯數,汽車竊盜,10,10,0
106,18-23歲嫌犯數,機車竊盜,59,53,6
106,18-23歲嫌犯數,贓物,3,3,0
106,18-23歲嫌犯數,賭博,133,109,24
106,18-23歲嫌犯數,傷害總計,220,208,12
106,18-23歲嫌犯數,重傷害,0,0,0
106,18-23歲嫌犯數,一般傷害,220,208,12
106,18-23歲嫌犯數,詐欺背信總計,798,625,173
106,18-23歲嫌犯數,詐欺,793,623,170
106,18-23歲嫌犯數,背信,5,2,3
106,18-23歲嫌犯數,妨害自由,132,116,16
106,18-23歲嫌犯數,殺人總計,19,17,2
106,18-23歲嫌犯數,故意殺人,19,17,2
106,18-23歲嫌犯數,過失致死,0,0,0
106,18-23歲嫌犯數,駕駛過失,170,132,38
106,18-23歲嫌犯數,妨害婚姻及家庭,7,4,3
106,18-23歲嫌犯數,妨害風化,14,12,2
106,18-23歲嫌犯數,妨害性自主罪總計,104,103,1
106,18-23歲嫌犯數,強制性交,9,9,0
106,18-23歲嫌犯數,共同強制性交,0,0,0
106,18-23歲嫌犯數,對幼性交,1,1,0
106,18-23歲嫌犯數,性交猥褻,94,93,1
106,18-23歲嫌犯數,內亂,0,0,0
106,18-23歲嫌犯數,恐嚇取財總計,37,36,1
106,18-23歲嫌犯數,重大恐嚇取財,0,0,0
106,18-23歲嫌犯數,一般恐嚇取財,37,36,1
106,18-23歲嫌犯數,擄人勒贖,0,0,0
106,18-23歲嫌犯數,侵占,55,42,13
106,18-23歲嫌犯數,偽造文書印文,42,32,10
106,18-23歲嫌犯數,違反毒品危害防制條例總計,2067,1751,316
106,18-23歲嫌犯數,第一級毒品,41,25,16
106,18-23歲嫌犯數,第二級毒品,1697,1418,279
106,18-23歲嫌犯數,第三級毒品,328,307,21
106,18-23歲嫌犯數,第四級毒品,0,0,0
106,18-23歲嫌犯數,其他,1,1,0
106,18-23歲嫌犯數,毀棄損壞,51,46,5
106,18-23歲嫌犯數,妨害公務,26,25,1
106,18-23歲嫌犯數,違反著作權法,0,0,0
106,18-23歲嫌犯數,違反商標法,2,1,1
106,18-23歲嫌犯數,妨害電腦使用,13,7,6
106,18-23歲嫌犯數,強盜搶奪總計,9,8,1
106,18-23歲嫌犯數,強盜,8,7,1
106,18-23歲嫌犯數,搶奪,1,1,0
106,18-23歲嫌犯數,竊佔,0,0,0
106,18-23歲嫌犯數,偽造有價證券,2,2,0
106,18-23歲嫌犯數,妨害秩序,217,206,11
106,18-23歲嫌犯數,違反藥事法,2,0,2
106,18-23歲嫌犯數,違反國家總動員法,0,0,0
106,18-23歲嫌犯數,違反森林法,0,0,0
106,18-23歲嫌犯數,公共危險,389,345,44
106,18-23歲嫌犯數,侵害墳墓屍體,0,0,0
106,18-23歲嫌犯數,重利,48,48,0
106,18-23歲嫌犯數,妨害名譽,116,82,34
106,18-23歲嫌犯數,違反選罷法,0,0,0
106,18-23歲嫌犯數,妨害祕密,11,10,1
106,18-23歲嫌犯數,遺棄,2,1,1
106,18-23歲嫌犯數,違反貪污治罪條例,0,0,0
106,18-23歲嫌犯數,懲治走私條例,0,0,0
106,18-23歲嫌犯數,妨害兵役,0,0,0
106,18-23歲嫌犯數,偽造貨幣,0,0,0
106,18-23歲嫌犯數,偽造度量衡,0,0,0
106,18-23歲嫌犯數,偽證,0,0,0
106,18-23歲嫌犯數,誣告,6,2,4
106,18-23歲嫌犯數,湮滅證據,0,0,0
106,18-23歲嫌犯數,瀆職,0,0,0
106,18-23歲嫌犯數,脫逃,2,2,0
106,18-23歲嫌犯數,藏匿頂替,1,1,0
106,18-23歲嫌犯數,違反槍砲彈藥刀械管制條例,58,54,4
106,18-23歲嫌犯數,違反就業服務法,0,0,0
106,18-23歲嫌犯數,其他,227,179,48
106,24-29歲嫌犯數,總計,5146,4193,953
106,24-29歲嫌犯數,竊盜總計,396,318,78
106,24-29歲嫌犯數,重大竊盜,2,2,0
106,24-29歲嫌犯數,普通竊盜,325,253,72
106,24-29歲嫌犯數,汽車竊盜,14,13,1
106,24-29歲嫌犯數,機車竊盜,55,50,5
106,24-29歲嫌犯數,贓物,5,5,0
106,24-29歲嫌犯數,賭博,146,121,25
106,24-29歲嫌犯數,傷害總計,190,170,20
106,24-29歲嫌犯數,重傷害,0,0,0
106,24-29歲嫌犯數,一般傷害,190,170,20
106,24-29歲嫌犯數,詐欺背信總計,668,507,161
106,24-29歲嫌犯數,詐欺,653,498,155
106,24-29歲嫌犯數,背信,15,9,6
106,24-29歲嫌犯數,妨害自由,132,109,23
106,24-29歲嫌犯數,殺人總計,12,11,1
106,24-29歲嫌犯數,故意殺人,11,11,0
106,24-29歲嫌犯數,過失致死,1,0,1
106,24-29歲嫌犯數,駕駛過失,123,100,23
106,24-29歲嫌犯數,妨害婚姻及家庭,12,8,4
106,24-29歲嫌犯數,妨害風化,22,15,7
106,24-29歲嫌犯數,妨害性自主罪總計,61,61,0
106,24-29歲嫌犯數,強制性交,5,5,0
106,24-29歲嫌犯數,共同強制性交,0,0,0
106,24-29歲嫌犯數,對幼性交,2,2,0
106,24-29歲嫌犯數,性交猥褻,54,54,0
106,24-29歲嫌犯數,內亂,0,0,0
106,24-29歲嫌犯數,恐嚇取財總計,16,12,4
106,24-29歲嫌犯數,重大恐嚇取財,0,0,0
106,24-29歲嫌犯數,一般恐嚇取財,16,12,4
106,24-29歲嫌犯數,擄人勒贖,0,0,0
106,24-29歲嫌犯數,侵占,74,49,25
106,24-29歲嫌犯數,偽造文書印文,67,57,10
106,24-29歲嫌犯數,違反毒品危害防制條例總計,2063,1699,364
106,24-29歲嫌犯數,第一級毒品,100,64,36
106,24-29歲嫌犯數,第二級毒品,1848,1532,316
106,24-29歲嫌犯數,第三級毒品,115,103,12
106,24-29歲嫌犯數,第四級毒品,0,0,0
106,24-29歲嫌犯數,其他,0,0,0
106,24-29歲嫌犯數,毀棄損壞,49,39,10
106,24-29歲嫌犯數,妨害公務,36,34,2
106,24-29歲嫌犯數,違反著作權法,8,8,0
106,24-29歲嫌犯數,違反商標法,12,4,8
106,24-29歲嫌犯數,妨害電腦使用,26,22,4
106,24-29歲嫌犯數,強盜搶奪總計,21,20,1
106,24-29歲嫌犯數,強盜,18,17,1
106,24-29歲嫌犯數,搶奪,3,3,0
106,24-29歲嫌犯數,竊佔,1,1,0
106,24-29歲嫌犯數,偽造有價證券,1,0,1
106,24-29歲嫌犯數,妨害秩序,62,58,4
106,24-29歲嫌犯數,違反藥事法,1,1,0
106,24-29歲嫌犯數,違反國家總動員法,0,0,0
106,24-29歲嫌犯數,違反森林法,0,0,0
106,24-29歲嫌犯數,公共危險,449,404,45
106,24-29歲嫌犯數,侵害墳墓屍體,0,0,0
106,24-29歲嫌犯數,重利,73,73,0
106,24-29歲嫌犯數,妨害名譽,94,67,27
106,24-29歲嫌犯數,違反選罷法,0,0,0
106,24-29歲嫌犯數,妨害祕密,12,10,2
106,24-29歲嫌犯數,遺棄,0,0,0
106,24-29歲嫌犯數,違反貪污治罪條例,0,0,0
106,24-29歲嫌犯數,懲治走私條例,0,0,0
106,24-29歲嫌犯數,妨害兵役,0,0,0
106,24-29歲嫌犯數,偽造貨幣,0,0,0
106,24-29歲嫌犯數,偽造度量衡,0,0,0
106,24-29歲嫌犯數,偽證,0,0,0
106,24-29歲嫌犯數,誣告,1,1,0
106,24-29歲嫌犯數,湮滅證據,0,0,0
106,24-29歲嫌犯數,瀆職,0,0,0
106,24-29歲嫌犯數,脫逃,0,0,0
106,24-29歲嫌犯數,藏匿頂替,2,1,1
106,24-29歲嫌犯數,違反槍砲彈藥刀械管制條例,53,49,4
106,24-29歲嫌犯數,違反就業服務法,0,0,0
106,24-29歲嫌犯數,其他,258,159,99
106,30-39歲嫌犯數,總計,9823,8081,1742
106,30-39歲嫌犯數,竊盜總計,1247,1015,232
106,30-39歲嫌犯數,重大竊盜,1,1,0
106,30-39歲嫌犯數,普通竊盜,1091,878,213
106,30-39歲嫌犯數,汽車竊盜,46,41,5
106,30-39歲嫌犯數,機車竊盜,109,95,14
106,30-39歲嫌犯數,贓物,6,5,1
106,30-39歲嫌犯數,賭博,188,155,33
106,30-39歲嫌犯數,傷害總計,332,284,48
106,30-39歲嫌犯數,重傷害,1,1,0
106,30-39歲嫌犯數,一般傷害,331,283,48
106,30-39歲嫌犯數,詐欺背信總計,611,422,189
106,30-39歲嫌犯數,詐欺,584,400,184
106,30-39歲嫌犯數,背信,27,22,5
106,30-39歲嫌犯數,妨害自由,296,250,46
106,30-39歲嫌犯數,殺人總計,12,9,3
106,30-39歲嫌犯數,故意殺人,10,8,2
106,30-39歲嫌犯數,過失致死,2,1,1
106,30-39歲嫌犯數,駕駛過失,196,160,36
106,30-39歲嫌犯數,妨害婚姻及家庭,30,17,13
106,30-39歲嫌犯數,妨害風化,59,37,22
106,30-39歲嫌犯數,妨害性自主罪總計,91,89,2
106,30-39歲嫌犯數,強制性交,8,8,0
106,30-39歲嫌犯數,共同強制性交,0,0,0
106,30-39歲嫌犯數,對幼性交,0,0,0
106,30-39歲嫌犯數,性交猥褻,83,81,2
106,30-39歲嫌犯數,內亂,0,0,0
106,30-39歲嫌犯數,恐嚇取財總計,27,24,3
106,30-39歲嫌犯數,重大恐嚇取財,0,0,0
106,30-39歲嫌犯數,一般恐嚇取財,27,24,3
106,30-39歲嫌犯數,擄人勒贖,0,0,0
106,30-39歲嫌犯數,侵占,108,72,36
106,30-39歲嫌犯數,偽造文書印文,109,79,30
106,30-39歲嫌犯數,違反毒品危害防制條例總計,3923,3340,583
106,30-39歲嫌犯數,第一級毒品,696,555,141
106,30-39歲嫌犯數,第二級毒品,3173,2738,435
106,30-39歲嫌犯數,第三級毒品,54,47,7
106,30-39歲嫌犯數,第四級毒品,0,0,0
106,30-39歲嫌犯數,其他,0,0,0
106,30-39歲嫌犯數,毀棄損壞,79,67,12
106,30-39歲嫌犯數,妨害公務,93,84,9
106,30-39歲嫌犯數,違反著作權法,59,52,7
106,30-39歲嫌犯數,違反商標法,15,5,10
106,30-39歲嫌犯數,妨害電腦使用,22,15,7
106,30-39歲嫌犯數,強盜搶奪總計,34,31,3
106,30-39歲嫌犯數,強盜,24,21,3
106,30-39歲嫌犯數,搶奪,10,10,0
106,30-39歲嫌犯數,竊佔,5,4,1
106,30-39歲嫌犯數,偽造有價證券,7,3,4
106,30-39歲嫌犯數,妨害秩序,55,53,2
106,30-39歲嫌犯數,違反藥事法,7,4,3
106,30-39歲嫌犯數,違反國家總動員法,0,0,0
106,30-39歲嫌犯數,違反森林法,0,0,0
106,30-39歲嫌犯數,公共危險,1368,1232,136
106,30-39歲嫌犯數,侵害墳墓屍體,0,0,0
106,30-39歲嫌犯數,重利,30,25,5
106,30-39歲嫌犯數,妨害名譽,168,110,58
106,30-39歲嫌犯數,違反選罷法,0,0,0
106,30-39歲嫌犯數,妨害祕密,16,14,2
106,30-39歲嫌犯數,遺棄,7,2,5
106,30-39歲嫌犯數,違反貪污治罪條例,0,0,0
106,30-39歲嫌犯數,懲治走私條例,0,0,0
106,30-39歲嫌犯數,妨害兵役,0,0,0
106,30-39歲嫌犯數,偽造貨幣,0,0,0
106,30-39歲嫌犯數,偽造度量衡,0,0,0
106,30-39歲嫌犯數,偽證,0,0,0
106,30-39歲嫌犯數,誣告,6,5,1
106,30-39歲嫌犯數,湮滅證據,0,0,0
106,30-39歲嫌犯數,瀆職,0,0,0
106,30-39歲嫌犯數,脫逃,1,0,1
106,30-39歲嫌犯數,藏匿頂替,3,2,1
106,30-39歲嫌犯數,違反槍砲彈藥刀械管制條例,88,82,6
106,30-39歲嫌犯數,違反就業服務法,0,0,0
106,30-39歲嫌犯數,其他,525,333,192
106,40-49歲嫌犯數,總計,8241,7016,1225
106,40-49歲嫌犯數,竊盜總計,1160,957,203
106,40-49歲嫌犯數,重大竊盜,1,1,0
106,40-49歲嫌犯數,普通竊盜,950,753,197
106,40-49歲嫌犯數,汽車竊盜,64,63,1
106,40-49歲嫌犯數,機車竊盜,145,140,5
106,40-49歲嫌犯數,贓物,4,4,0
106,40-49歲嫌犯數,賭博,183,145,38
106,40-49歲嫌犯數,傷害總計,360,287,73
106,40-49歲嫌犯數,重傷害,0,0,0
106,40-49歲嫌犯數,一般傷害,360,287,73
106,40-49歲嫌犯數,詐欺背信總計,310,217,93
106,40-49歲嫌犯數,詐欺,290,205,85
106,40-49歲嫌犯數,背信,20,12,8
106,40-49歲嫌犯數,妨害自由,254,212,42
106,40-49歲嫌犯數,殺人總計,7,7,0
106,40-49歲嫌犯數,故意殺人,7,7,0
106,40-49歲嫌犯數,過失致死,0,0,0
106,40-49歲嫌犯數,駕駛過失,185,146,39
106,40-49歲嫌犯數,妨害婚姻及家庭,29,14,15
106,40-49歲嫌犯數,妨害風化,39,23,16
106,40-49歲嫌犯數,妨害性自主罪總計,54,54,0
106,40-49歲嫌犯數,強制性交,8,8,0
106,40-49歲嫌犯數,共同強制性交,0,0,0
106,40-49歲嫌犯數,對幼性交,0,0,0
106,40-49歲嫌犯數,性交猥褻,46,46,0
106,40-49歲嫌犯數,內亂,0,0,0
106,40-49歲嫌犯數,恐嚇取財總計,21,16,5
106,40-49歲嫌犯數,重大恐嚇取財,0,0,0
106,40-49歲嫌犯數,一般恐嚇取財,21,16,5
106,40-49歲嫌犯數,擄人勒贖,0,0,0
106,40-49歲嫌犯數,侵占,121,81,40
106,40-49歲嫌犯數,偽造文書印文,75,47,28
106,40-49歲嫌犯數,違反毒品危害防制條例總計,2673,2401,272
106,40-49歲嫌犯數,第一級毒品,713,628,85
106,40-49歲嫌犯數,第二級毒品,1948,1761,187
106,40-49歲嫌犯數,第三級毒品,11,11,0
106,40-49歲嫌犯數,第四級毒品,0,0,0
106,40-49歲嫌犯數,其他,1,1,0
106,40-49歲嫌犯數,毀棄損壞,76,65,11
106,40-49歲嫌犯數,妨害公務,78,72,6
106,40-49歲嫌犯數,違反著作權法,48,36,12
106,40-49歲嫌犯數,違反商標法,6,2,4
106,40-49歲嫌犯數,妨害電腦使用,11,8,3
106,40-49歲嫌犯數,強盜搶奪總計,20,17,3
106,40-49歲嫌犯數,強盜,10,8,2
106,40-49歲嫌犯數,搶奪,10,9,1
106,40-49歲嫌犯數,竊佔,19,17,2
106,40-49歲嫌犯數,偽造有價證券,4,4,0
106,40-49歲嫌犯數,妨害秩序,18,17,1
106,40-49歲嫌犯數,違反藥事法,3,2,1
106,40-49歲嫌犯數,違反國家總動員法,0,0,0
106,40-49歲嫌犯數,違反森林法,2,2,0
106,40-49歲嫌犯數,公共危險,1803,1666,137
106,40-49歲嫌犯數,侵害墳墓屍體,0,0,0
106,40-49歲嫌犯數,重利,51,50,1
106,40-49歲嫌犯數,妨害名譽,125,86,39
106,40-49歲嫌犯數,違反選罷法,0,0,0
106,40-49歲嫌犯數,妨害祕密,16,13,3
106,40-49歲嫌犯數,遺棄,5,2,3
106,40-49歲嫌犯數,違反貪污治罪條例,0,0,0
106,40-49歲嫌犯數,懲治走私條例,0,0,0
106,40-49歲嫌犯數,妨害兵役,0,0,0
106,40-49歲嫌犯數,偽造貨幣,0,0,0
106,40-49歲嫌犯數,偽造度量衡,0,0,0
106,40-49歲嫌犯數,偽證,0,0,0
106,40-49歲嫌犯數,誣告,8,3,5
106,40-49歲嫌犯數,湮滅證據,1,1,0
106,40-49歲嫌犯數,瀆職,0,0,0
106,40-49歲嫌犯數,脫逃,1,0,1
106,40-49歲嫌犯數,藏匿頂替,1,1,0
106,40-49歲嫌犯數,違反槍砲彈藥刀械管制條例,39,38,1
106,40-49歲嫌犯數,違反就業服務法,0,0,0
106,40-49歲嫌犯數,其他,431,303,128
106,50-59歲嫌犯數,總計,4762,3938,824
106,50-59歲嫌犯數,竊盜總計,708,525,183
106,50-59歲嫌犯數,重大竊盜,0,0,0
106,50-59歲嫌犯數,普通竊盜,654,473,181
106,50-59歲嫌犯數,汽車竊盜,13,13,0
106,50-59歲嫌犯數,機車竊盜,41,39,2
106,50-59歲嫌犯數,贓物,4,4,0
106,50-59歲嫌犯數,賭博,257,160,97
106,50-59歲嫌犯數,傷害總計,213,169,44
106,50-59歲嫌犯數,重傷害,0,0,0
106,50-59歲嫌犯數,一般傷害,213,169,44
106,50-59歲嫌犯數,詐欺背信總計,169,113,56
106,50-59歲嫌犯數,詐欺,157,105,52
106,50-59歲嫌犯數,背信,12,8,4
106,50-59歲嫌犯數,妨害自由,188,147,41
106,50-59歲嫌犯數,殺人總計,3,3,0
106,50-59歲嫌犯數,故意殺人,2,2,0
106,50-59歲嫌犯數,過失致死,1,1,0
106,50-59歲嫌犯數,駕駛過失,186,159,27
106,50-59歲嫌犯數,妨害婚姻及家庭,11,9,2
106,50-59歲嫌犯數,妨害風化,16,11,5
106,50-59歲嫌犯數,妨害性自主罪總計,42,42,0
106,50-59歲嫌犯數,強制性交,1,1,0
106,50-59歲嫌犯數,共同強制性交,0,0,0
106,50-59歲嫌犯數,對幼性交,0,0,0
106,50-59歲嫌犯數,性交猥褻,41,41,0
106,50-59歲嫌犯數,內亂,0,0,0
106,50-59歲嫌犯數,恐嚇取財總計,7,7,0
106,50-59歲嫌犯數,重大恐嚇取財,0,0,0
106,50-59歲嫌犯數,一般恐嚇取財,7,7,0
106,50-59歲嫌犯數,擄人勒贖,0,0,0
106,50-59歲嫌犯數,侵占,71,45,26
106,50-59歲嫌犯數,偽造文書印文,38,24,14
106,50-59歲嫌犯數,違反毒品危害防制條例總計,713,660,53
106,50-59歲嫌犯數,第一級毒品,235,225,10
106,50-59歲嫌犯數,第二級毒品,474,432,42
106,50-59歲嫌犯數,第三級毒品,3,2,1
106,50-59歲嫌犯數,第四級毒品,1,1,0
106,50-59歲嫌犯數,其他,0,0,0
106,50-59歲嫌犯數,毀棄損壞,73,61,12
106,50-59歲嫌犯數,妨害公務,52,46,6
106,50-59歲嫌犯數,違反著作權法,32,21,11
106,50-59歲嫌犯數,違反商標法,2,1,1
106,50-59歲嫌犯數,妨害電腦使用,5,2,3
106,50-59歲嫌犯數,強盜搶奪總計,9,7,2
106,50-59歲嫌犯數,強盜,7,5,2
106,50-59歲嫌犯數,搶奪,2,2,0
106,50-59歲嫌犯數,竊佔,24,17,7
106,50-59歲嫌犯數,偽造有價證券,2,2,0
106,50-59歲嫌犯數,妨害秩序,6,5,1
106,50-59歲嫌犯數,違反藥事法,1,0,1
106,50-59歲嫌犯數,違反國家總動員法,0,0,0
106,50-59歲嫌犯數,違反森林法,4,4,0
106,50-59歲嫌犯數,公共危險,1563,1439,124
106,50-59歲嫌犯數,侵害墳墓屍體,0,0,0
106,50-59歲嫌犯數,重利,9,7,2
106,50-59歲嫌犯數,妨害名譽,122,77,45
106,50-59歲嫌犯數,違反選罷法,0,0,0
106,50-59歲嫌犯數,妨害祕密,6,4,2
106,50-59歲嫌犯數,遺棄,5,0,5
106,50-59歲嫌犯數,違反貪污治罪條例,0,0,0
106,50-59歲嫌犯數,懲治走私條例,0,0,0
106,50-59歲嫌犯數,妨害兵役,0,0,0
106,50-59歲嫌犯數,偽造貨幣,2,2,0
106,50-59歲嫌犯數,偽造度量衡,0,0,0
106,50-59歲嫌犯數,偽證,0,0,0
106,50-59歲嫌犯數,誣告,9,8,1
106,50-59歲嫌犯數,湮滅證據,0,0,0
106,50-59歲嫌犯數,瀆職,0,0,0
106,50-59歲嫌犯數,脫逃,0,0,0
106,50-59歲嫌犯數,藏匿頂替,0,0,0
106,50-59歲嫌犯數,違反槍砲彈藥刀械管制條例,11,10,1
106,50-59歲嫌犯數,違反就業服務法,0,0,0
106,50-59歲嫌犯數,其他,199,147,52
106,60-64歲嫌犯數,總計,1405,1085,320
106,60-64歲嫌犯數,竊盜總計,266,170,96
106,60-64歲嫌犯數,重大竊盜,0,0,0
106,60-64歲嫌犯數,普通竊盜,246,151,95
106,60-64歲嫌犯數,汽車竊盜,0,0,0
106,60-64歲嫌犯數,機車竊盜,20,19,1
106,60-64歲嫌犯數,贓物,0,0,0
106,60-64歲嫌犯數,賭博,144,93,51
106,60-64歲嫌犯數,傷害總計,82,63,19
106,60-64歲嫌犯數,重傷害,0,0,0
106,60-64歲嫌犯數,一般傷害,82,63,19
106,60-64歲嫌犯數,詐欺背信總計,40,22,18
106,60-64歲嫌犯數,詐欺,37,22,15
106,60-64歲嫌犯數,背信,3,0,3
106,60-64歲嫌犯數,妨害自由,52,40,12
106,60-64歲嫌犯數,殺人總計,1,1,0
106,60-64歲嫌犯數,故意殺人,1,1,0
106,60-64歲嫌犯數,過失致死,0,0,0
106,60-64歲嫌犯數,駕駛過失,83,69,14
106,60-64歲嫌犯數,妨害婚姻及家庭,5,3,2
106,60-64歲嫌犯數,妨害風化,12,5,7
106,60-64歲嫌犯數,妨害性自主罪總計,10,9,1
106,60-64歲嫌犯數,強制性交,1,1,0
106,60-64歲嫌犯數,共同強制性交,0,0,0
106,60-64歲嫌犯數,對幼性交,1,1,0
106,60-64歲嫌犯數,性交猥褻,8,7,1
106,60-64歲嫌犯數,內亂,0,0,0
106,60-64歲嫌犯數,恐嚇取財總計,1,1,0
106,60-64歲嫌犯數,重大恐嚇取財,0,0,0
106,60-64歲嫌犯數,一般恐嚇取財,1,1,0
106,60-64歲嫌犯數,擄人勒贖,0,0,0
106,60-64歲嫌犯數,侵占,34,22,12
106,60-64歲嫌犯數,偽造文書印文,8,4,4
106,60-64歲嫌犯數,違反毒品危害防制條例總計,108,97,11
106,60-64歲嫌犯數,第一級毒品,40,35,5
106,60-64歲嫌犯數,第二級毒品,66,61,5
106,60-64歲嫌犯數,第三級毒品,2,1,1
106,60-64歲嫌犯數,第四級毒品,0,0,0
106,60-64歲嫌犯數,其他,0,0,0
106,60-64歲嫌犯數,毀棄損壞,19,16,3
106,60-64歲嫌犯數,妨害公務,13,10,3
106,60-64歲嫌犯數,違反著作權法,8,6,2
106,60-64歲嫌犯數,違反商標法,1,1,0
106,60-64歲嫌犯數,妨害電腦使用,2,2,0
106,60-64歲嫌犯數,強盜搶奪總計,1,0,1
106,60-64歲嫌犯數,強盜,1,0,1
106,60-64歲嫌犯數,搶奪,0,0,0
106,60-64歲嫌犯數,竊佔,6,6,0
106,60-64歲嫌犯數,偽造有價證券,0,0,0
106,60-64歲嫌犯數,妨害秩序,0,0,0
106,60-64歲嫌犯數,違反藥事法,0,0,0
106,60-64歲嫌犯數,違反國家總動員法,0,0,0
106,60-64歲嫌犯數,違反森林法,2,2,0
106,60-64歲嫌犯數,公共危險,399,374,25
106,60-64歲嫌犯數,侵害墳墓屍體,0,0,0
106,60-64歲嫌犯數,重利,2,0,2
106,60-64歲嫌犯數,妨害名譽,44,25,19
106,60-64歲嫌犯數,違反選罷法,0,0,0
106,60-64歲嫌犯數,妨害祕密,0,0,0
106,60-64歲嫌犯數,遺棄,1,0,1
106,60-64歲嫌犯數,違反貪污治罪條例,0,0,0
106,60-64歲嫌犯數,懲治走私條例,0,0,0
106,60-64歲嫌犯數,妨害兵役,0,0,0
106,60-64歲嫌犯數,偽造貨幣,0,0,0
106,60-64歲嫌犯數,偽造度量衡,0,0,0
106,60-64歲嫌犯數,偽證,0,0,0
106,60-64歲嫌犯數,誣告,2,0,2
106,60-64歲嫌犯數,湮滅證據,0,0,0
106,60-64歲嫌犯數,瀆職,0,0,0
106,60-64歲嫌犯數,脫逃,0,0,0
106,60-64歲嫌犯數,藏匿頂替,0,0,0
106,60-64歲嫌犯數,違反槍砲彈藥刀械管制條例,1,1,0
106,60-64歲嫌犯數,違反就業服務法,1,0,1
106,60-64歲嫌犯數,其他,57,43,14
106,65-69歲嫌犯數,總計,736,570,166
106,65-69歲嫌犯數,竊盜總計,151,88,63
106,65-69歲嫌犯數,重大竊盜,0,0,0
106,65-69歲嫌犯數,普通竊盜,147,85,62
106,65-69歲嫌犯數,汽車竊盜,2,2,0
106,65-69歲嫌犯數,機車竊盜,2,1,1
106,65-69歲嫌犯數,贓物,2,0,2
106,65-69歲嫌犯數,賭博,102,71,31
106,65-69歲嫌犯數,傷害總計,50,39,11
106,65-69歲嫌犯數,重傷害,0,0,0
106,65-69歲嫌犯數,一般傷害,50,39,11
106,65-69歲嫌犯數,詐欺背信總計,26,24,2
106,65-69歲嫌犯數,詐欺,22,20,2
106,65-69歲嫌犯數,背信,4,4,0
106,65-69歲嫌犯數,妨害自由,34,25,9
106,65-69歲嫌犯數,殺人總計,1,1,0
106,65-69歲嫌犯數,故意殺人,1,1,0
106,65-69歲嫌犯數,過失致死,0,0,0
106,65-69歲嫌犯數,駕駛過失,45,42,3
106,65-69歲嫌犯數,妨害婚姻及家庭,2,2,0
106,65-69歲嫌犯數,妨害風化,1,0,1
106,65-69歲嫌犯數,妨害性自主罪總計,7,7,0
106,65-69歲嫌犯數,強制性交,0,0,0
106,65-69歲嫌犯數,共同強制性交,0,0,0
106,65-69歲嫌犯數,對幼性交,1,1,0
106,65-69歲嫌犯數,性交猥褻,6,6,0
106,65-69歲嫌犯數,內亂,0,0,0
106,65-69歲嫌犯數,恐嚇取財總計,1,1,0
106,65-69歲嫌犯數,重大恐嚇取財,0,0,0
106,65-69歲嫌犯數,一般恐嚇取財,1,1,0
106,65-69歲嫌犯數,擄人勒贖,0,0,0
106,65-69歲嫌犯數,侵占,16,8,8
106,65-69歲嫌犯數,偽造文書印文,8,4,4
106,65-69歲嫌犯數,違反毒品危害防制條例總計,29,29,0
106,65-69歲嫌犯數,第一級毒品,13,13,0
106,65-69歲嫌犯數,第二級毒品,16,16,0
106,65-69歲嫌犯數,第三級毒品,0,0,0
106,65-69歲嫌犯數,第四級毒品,0,0,0
106,65-69歲嫌犯數,其他,0,0,0
106,65-69歲嫌犯數,毀棄損壞,12,6,6
106,65-69歲嫌犯數,妨害公務,2,2,0
106,65-69歲嫌犯數,違反著作權法,3,2,1
106,65-69歲嫌犯數,違反商標法,0,0,0
106,65-69歲嫌犯數,妨害電腦使用,1,0,1
106,65-69歲嫌犯數,強盜搶奪總計,1,1,0
106,65-69歲嫌犯數,強盜,0,0,0
106,65-69歲嫌犯數,搶奪,1,1,0
106,65-69歲嫌犯數,竊佔,2,2,0
106,65-69歲嫌犯數,偽造有價證券,0,0,0
106,65-69歲嫌犯數,妨害秩序,0,0,0
106,65-69歲嫌犯數,違反藥事法,0,0,0
106,65-69歲嫌犯數,違反國家總動員法,0,0,0
106,65-69歲嫌犯數,違反森林法,0,0,0
106,65-69歲嫌犯數,公共危險,175,166,9
106,65-69歲嫌犯數,侵害墳墓屍體,0,0,0
106,65-69歲嫌犯數,重利,1,0,1
106,65-69歲嫌犯數,妨害名譽,23,14,9
106,65-69歲嫌犯數,違反選罷法,0,0,0
106,65-69歲嫌犯數,妨害祕密,0,0,0
106,65-69歲嫌犯數,遺棄,0,0,0
106,65-69歲嫌犯數,違反貪污治罪條例,0,0,0
106,65-69歲嫌犯數,懲治走私條例,0,0,0
106,65-69歲嫌犯數,妨害兵役,0,0,0
106,65-69歲嫌犯數,偽造貨幣,0,0,0
106,65-69歲嫌犯數,偽造度量衡,0,0,0
106,65-69歲嫌犯數,偽證,0,0,0
106,65-69歲嫌犯數,誣告,2,2,0
106,65-69歲嫌犯數,湮滅證據,0,0,0
106,65-69歲嫌犯數,瀆職,0,0,0
106,65-69歲嫌犯數,脫逃,0,0,0
106,65-69歲嫌犯數,藏匿頂替,0,0,0
106,65-69歲嫌犯數,違反槍砲彈藥刀械管制條例,0,0,0
106,65-69歲嫌犯數,違反就業服務法,0,0,0
106,65-69歲嫌犯數,其他,39,34,5
106,70歲以上嫌犯數,總計,487,348,139
106,70歲以上嫌犯數,竊盜總計,159,91,68
106,70歲以上嫌犯數,重大竊盜,0,0,0
106,70歲以上嫌犯數,普通竊盜,156,89,67
106,70歲以上嫌犯數,汽車竊盜,0,0,0
106,70歲以上嫌犯數,機車竊盜,3,2,1
106,70歲以上嫌犯數,贓物,0,0,0
106,70歲以上嫌犯數,賭博,70,48,22
106,70歲以上嫌犯數,傷害總計,34,26,8
106,70歲以上嫌犯數,重傷害,0,0,0
106,70歲以上嫌犯數,一般傷害,34,26,8
106,70歲以上嫌犯數,詐欺背信總計,9,6,3
106,70歲以上嫌犯數,詐欺,8,6,2
106,70歲以上嫌犯數,背信,1,0,1
106,70歲以上嫌犯數,妨害自由,15,11,4
106,70歲以上嫌犯數,殺人總計,0,0,0
106,70歲以上嫌犯數,故意殺人,0,0,0
106,70歲以上嫌犯數,過失致死,0,0,0
106,70歲以上嫌犯數,駕駛過失,22,17,5
106,70歲以上嫌犯數,妨害婚姻及家庭,0,0,0
106,70歲以上嫌犯數,妨害風化,1,0,1
106,70歲以上嫌犯數,妨害性自主罪總計,11,11,0
106,70歲以上嫌犯數,強制性交,1,1,0
106,70歲以上嫌犯數,共同強制性交,0,0,0
106,70歲以上嫌犯數,對幼性交,0,0,0
106,70歲以上嫌犯數,性交猥褻,10,10,0
106,70歲以上嫌犯數,內亂,0,0,0
106,70歲以上嫌犯數,恐嚇取財總計,0,0,0
106,70歲以上嫌犯數,重大恐嚇取財,0,0,0
106,70歲以上嫌犯數,一般恐嚇取財,0,0,0
106,70歲以上嫌犯數,擄人勒贖,0,0,0
106,70歲以上嫌犯數,侵占,16,9,7
106,70歲以上嫌犯數,偽造文書印文,3,1,2
106,70歲以上嫌犯數,違反毒品危害防制條例總計,12,10,2
106,70歲以上嫌犯數,第一級毒品,7,7,0
106,70歲以上嫌犯數,第二級毒品,5,3,2
106,70歲以上嫌犯數,第三級毒品,0,0,0
106,70歲以上嫌犯數,第四級毒品,0,0,0
106,70歲以上嫌犯數,其他,0,0,0
106,70歲以上嫌犯數,毀棄損壞,11,10,1
106,70歲以上嫌犯數,妨害公務,5,5,0
106,70歲以上嫌犯數,違反著作權法,2,2,0
106,70歲以上嫌犯數,違反商標法,0,0,0
106,70歲以上嫌犯數,妨害電腦使用,1,1,0
106,70歲以上嫌犯數,強盜搶奪總計,0,0,0
106,70歲以上嫌犯數,強盜,0,0,0
106,70歲以上嫌犯數,搶奪,0,0,0
106,70歲以上嫌犯數,竊佔,9,5,4
106,70歲以上嫌犯數,偽造有價證券,0,0,0
106,70歲以上嫌犯數,妨害秩序,0,0,0
106,70歲以上嫌犯數,違反藥事法,0,0,0
106,70歲以上嫌犯數,違反國家總動員法,0,0,0
106,70歲以上嫌犯數,違反森林法,0,0,0
106,70歲以上嫌犯數,公共危險,72,67,5
106,70歲以上嫌犯數,侵害墳墓屍體,0,0,0
106,70歲以上嫌犯數,重利,0,0,0
106,70歲以上嫌犯數,妨害名譽,14,11,3
106,70歲以上嫌犯數,違反選罷法,0,0,0
106,70歲以上嫌犯數,妨害祕密,0,0,0
106,70歲以上嫌犯數,遺棄,0,0,0
106,70歲以上嫌犯數,違反貪污治罪條例,0,0,0
106,70歲以上嫌犯數,懲治走私條例,0,0,0
106,70歲以上嫌犯數,妨害兵役,0,0,0
106,70歲以上嫌犯數,偽造貨幣,0,0,0
106,70歲以上嫌犯數,偽造度量衡,0,0,0
106,70歲以上嫌犯數,偽證,0,0,0
106,70歲以上嫌犯數,誣告,0,0,0
106,70歲以上嫌犯數,湮滅證據,0,0,0
106,70歲以上嫌犯數,瀆職,0,0,0
106,70歲以上嫌犯數,脫逃,0,0,0
106,70歲以上嫌犯數,藏匿頂替,0,0,0
106,70歲以上嫌犯數,違反槍砲彈藥刀械管制條例,0,0,0
106,70歲以上嫌犯數,違反就業服務法,0,0,0
106,70歲以上嫌犯數,其他,21,17,4
106,年齡不詳嫌犯數,總計,1,1,0
106,年齡不詳嫌犯數,竊盜總計,0,0,0
106,年齡不詳嫌犯數,重大竊盜,0,0,0
106,年齡不詳嫌犯數,普通竊盜,0,0,0
106,年齡不詳嫌犯數,汽車竊盜,0,0,0
106,年齡不詳嫌犯數,機車竊盜,0,0,0
106,年齡不詳嫌犯數,贓物,0,0,0
106,年齡不詳嫌犯數,賭博,0,0,0
106,年齡不詳嫌犯數,傷害總計,1,1,0
106,年齡不詳嫌犯數,重傷害,0,0,0
106,年齡不詳嫌犯數,一般傷害,1,1,0
106,年齡不詳嫌犯數,詐欺背信總計,0,0,0
106,年齡不詳嫌犯數,詐欺,0,0,0
106,年齡不詳嫌犯數,背信,0,0,0
106,年齡不詳嫌犯數,妨害自由,0,0,0
106,年齡不詳嫌犯數,殺人總計,0,0,0
106,年齡不詳嫌犯數,故意殺人,0,0,0
106,年齡不詳嫌犯數,過失致死,0,0,0
106,年齡不詳嫌犯數,駕駛過失,0,0,0
106,年齡不詳嫌犯數,妨害婚姻及家庭,0,0,0
106,年齡不詳嫌犯數,妨害風化,0,0,0
106,年齡不詳嫌犯數,妨害性自主罪總計,0,0,0
106,年齡不詳嫌犯數,強制性交,0,0,0
106,年齡不詳嫌犯數,共同強制性交,0,0,0
106,年齡不詳嫌犯數,對幼性交,0,0,0
106,年齡不詳嫌犯數,性交猥褻,0,0,0
106,年齡不詳嫌犯數,內亂,0,0,0
106,年齡不詳嫌犯數,恐嚇取財總計,0,0,0
106,年齡不詳嫌犯數,重大恐嚇取財,0,0,0
106,年齡不詳嫌犯數,一般恐嚇取財,0,0,0
106,年齡不詳嫌犯數,擄人勒贖,0,0,0
106,年齡不詳嫌犯數,侵占,0,0,0
106,年齡不詳嫌犯數,偽造文書印文,0,0,0
106,年齡不詳嫌犯數,違反毒品危害防制條例總計,0,0,0
106,年齡不詳嫌犯數,第一級毒品,0,0,0
106,年齡不詳嫌犯數,第二級毒品,0,0,0
106,年齡不詳嫌犯數,第三級毒品,0,0,0
106,年齡不詳嫌犯數,第四級毒品,0,0,0
106,年齡不詳嫌犯數,其他,0,0,0
106,年齡不詳嫌犯數,毀棄損壞,0,0,0
106,年齡不詳嫌犯數,妨害公務,0,0,0
106,年齡不詳嫌犯數,違反著作權法,0,0,0
106,年齡不詳嫌犯數,違反商標法,0,0,0
106,年齡不詳嫌犯數,妨害電腦使用,0,0,0
106,年齡不詳嫌犯數,強盜搶奪總計,0,0,0
106,年齡不詳嫌犯數,強盜,0,0,0
106,年齡不詳嫌犯數,搶奪,0,0,0
106,年齡不詳嫌犯數,竊佔,0,0,0
106,年齡不詳嫌犯數,偽造有價證券,0,0,0
106,年齡不詳嫌犯數,妨害秩序,0,0,0
106,年齡不詳嫌犯數,違反藥事法,0,0,0
106,年齡不詳嫌犯數,違反國家總動員法,0,0,0
106,年齡不詳嫌犯數,違反森林法,0,0,0
106,年齡不詳嫌犯數,公共危險,0,0,0
106,年齡不詳嫌犯數,侵害墳墓屍體,0,0,0
106,年齡不詳嫌犯數,重利,0,0,0
106,年齡不詳嫌犯數,妨害名譽,0,0,0
106,年齡不詳嫌犯數,違反選罷法,0,0,0
106,年齡不詳嫌犯數,妨害祕密,0,0,0
106,年齡不詳嫌犯數,遺棄,0,0,0
106,年齡不詳嫌犯數,違反貪污治罪條例,0,0,0
106,年齡不詳嫌犯數,懲治走私條例,0,0,0
106,年齡不詳嫌犯數,妨害兵役,0,0,0
106,年齡不詳嫌犯數,偽造貨幣,0,0,0
106,年齡不詳嫌犯數,偽造度量衡,0,0,0
106,年齡不詳嫌犯數,偽證,0,0,0
106,年齡不詳嫌犯數,誣告,0,0,0
106,年齡不詳嫌犯數,湮滅證據,0,0,0
106,年齡不詳嫌犯數,瀆職,0,0,0
106,年齡不詳嫌犯數,脫逃,0,0,0
106,年齡不詳嫌犯數,藏匿頂替,0,0,0
106,年齡不詳嫌犯數,違反槍砲彈藥刀械管制條例,0,0,0
106,年齡不詳嫌犯數,違反就業服務法,0,0,0
106,年齡不詳嫌犯數,其他,0,0,0
